我在想自杀。我想死。	情绪反应,情绪反应##情感效应
我是一个失败者，一个讨厌鬼，一个无趣的人	认知歪曲,认知歪曲##乱贴标签
我自残，我什么都做不好。我又懒又没用	认知歪曲,认知歪曲##放大和缩小,认知歪曲,认知歪曲##情绪化推理,情绪反应,情绪反应##行为效应
我死了对大家都好	认知歪曲,认知歪曲##否定正面思考
我没有技能，也没有关心我的朋友。	触发性事件,触发性事件##社会关系,认知歪曲,认知歪曲##妄下结论
我是个可怕的人	认知歪曲,认知歪曲##乱贴标签
我知道如果有人读到这篇文章，他们会说我是在寻求关注，我是在夸张。	认知歪曲,认知歪曲##妄下结论
这就是为什么我从不说任何关于我的感受，我把一切都藏在心里，因为没有人想听我的个人问题，没有人会关心	触发性事件,触发性事件##情感,认知歪曲,认知歪曲##妄下结论,认知歪曲,认知歪曲##情绪化推理
我在学校也做不好，我很笨。我的存在毫无意义	触发性事件,触发性事件##学习工作
没有我大家会过得更好	认知歪曲,认知歪曲##否定正面思考
我很抱歉分享我的问题/感受，没人会在意的	认知歪曲,认知歪曲##妄下结论,情绪反应,情绪反应##情感效应
我动这个念头也是不久前，导火索是妈妈病重估计有不了多长时间了	触发性事件,触发性事件##生活
导火索是妈妈病重估计有不了多长时间了。	触发性事件,触发性事件##疾病症状
起因是我家有家族性胃癌我不知道自己什么时候就会得病，不知道是过几年还是二十年还是四十年。	触发性事件,触发性事件##疾病症状
但我现在觉得那太晚了，我可能撑不到生病就想结束自己的生命。	触发性事件,触发性事件##情感
因为这个世界没意思，从小就和别的孩子攀比读书考学工作，然后结婚成家生完孩子之后，为他付出自己的后半辈子。	认知歪曲,认知歪曲##否定正面思考
以前很喜欢小孩子但现在不想要了，因为生个孩子特别损元气。如果不是妈妈生了弟弟她身体也不会透支	认知歪曲,认知歪曲##情绪化推理
但要是没有了她这一切都没意义了	认知歪曲,认知歪曲##心理过滤
上一次去医院我跟医生说完他又说了一些什么“想开心，开心点，没什么大不了”，	触发性事件,触发性事件##生活
我只想说开心点？我已经没有这种技能了	认知歪曲,认知歪曲##否定正面思考
你让我怎么做到，是啊，开心点，多好的方法我以前怎么能没想到过？	认知歪曲,认知歪曲##情绪化推理
我看着窗外留下了泪，那是个绝望的泪水，每次去医院过程又痛苦又会有一点期待，哪怕一点，我这次会不会变好一点，可又是一次落空。	情绪反应,情绪反应##情感效应
我想结束自己的生命，但我做不到，因为我害怕，也担心我的弟弟妹妹们	驳斥,驳斥##有效驳斥
没有人相信我	触发性事件,触发性事件##社会关系
令人沮丧的，这让我真的很伤心和生气	情绪反应,情绪反应##情感效应
我现在应该很坚强了，但我没有	认知歪曲,认知歪曲##应该句式
我不想让他们发现我的无助，因为我知道他们也想消失。	认知歪曲,认知歪曲##妄下结论
我的生活中不会有任何愉快的事情	认知歪曲,认知歪曲##以偏概全
如果不是因为我不想伤害我妈妈和朋友，我可能早就这么做了。	驳斥,驳斥##有效驳斥
对我来说没有幸福，不管是现在还是将来	认知歪曲,认知歪曲##以偏概全
我不知道是我命中注定没有幸福，还是我没有能力获得幸福	认知歪曲,认知歪曲##情绪化推理
中间割过三次腕	情绪反应,情绪反应##行为效应
复习压力多大一边是对未来的渺茫不确定一边是对他有新欢的心碎	触发性事件,触发性事件##学习工作,触发性事件,触发性事件##情感
边哭边写卷子	情绪反应,情绪反应##行为效应
一次次崩溃	情绪反应,情绪反应##情感效应
我没有信仰不相信爱情朋友	认知歪曲,认知歪曲##放大和缩小
我想开心的活着像没遇见他之前那样还是那么阳光干净开心的活着	驳斥,驳斥##有效驳斥
经常感到压力，有自杀倾向，焦虑不安	情绪反应,情绪反应##情感效应,情绪反应,情绪反应##行为效应
第一次惊恐发作。	触发性事件,触发性事件##疾病症状
这太可怕了，我从来没有真正从中恢复过来，我一直在走下坡路	认知歪曲,认知歪曲##情绪化推理
甚至像电影和主题公园这样的东西也会让我因为焦虑而想哭和想吐	情绪反应,情绪反应##行为效应
现在做什么事都太难了。	认知歪曲,认知歪曲##放大和缩小
我的记忆力和注意力都被完全破坏了，	认知歪曲,认知歪曲##放大和缩小
我恨死它了。	情绪反应,情绪反应##情感效应
我的父母在情感上完全不可用，毫无用处。	认知歪曲,认知歪曲##乱贴标签
每次我提起这件事，都会被忽视。	触发性事件,触发性事件##生活
我一个朋友都没有。	触发性事件,触发性事件##社会关系
每一天都让我感到疲惫和恐惧。	情绪反应,情绪反应##情感效应
我的脑子就是这么坏。	认知歪曲,认知歪曲##以偏概全
我真的只想死，把这事了结，我只想休息。我只想让一切都停止	驳斥,驳斥##习惯性驳斥
这是我一生中最糟糕的一年，希望也是最后一年。	认知歪曲,认知歪曲##情绪化推理
再过一周半我就死了。	认知歪曲,认知歪曲##妄下结论
我付不起大学学费	触发性事件,触发性事件##生活
他们也不会让我在多次挂科后回去。	认知歪曲,认知歪曲##妄下结论
所以我也是个罪犯。	认知歪曲,认知歪曲##罪责归己/他
如果我学不到医学，我还不如死了	认知歪曲,认知歪曲##非此即彼
对我这世界上最好的朋友假装他应该比我这样的失败者更好。	认知歪曲,认知歪曲##乱贴标签
那我也同意了，为什么还要逼我呢，我都同意去打工了，还在不停的骂我。	触发性事件,触发性事件##社会关系
我觉得我出生就是个错误吧。	认知歪曲,认知歪曲##罪责归己/他
我已经到了临界点了，我想死，他们告诉我不要死在他们面前。	情绪反应,情绪反应##情感效应
她怕自己犯法，要把我送去我爸那边，我可能会死的更快吧。	认知歪曲,认知歪曲##妄下结论
我又不畏惧死亡，这个世界没什么好留念的，我没有未来，人都会死，我只是提前一点。	认知歪曲,认知歪曲##否定正面思考
比起死我更畏惧活着，就算活着他们也会把我逼疯，希望没有下辈子让我永久的长眠	情绪反应,情绪反应##情感效应
比起死我更畏惧活着，就算活着他们也会把我逼疯，希望没有下辈子让我永久的长眠。	认知歪曲,认知歪曲##情绪化推理
我的生命要在20岁结束了	认知歪曲,认知歪曲##妄下结论
我的发际线是垃圾	认知歪曲,认知歪曲##乱贴标签
我有躁郁症，抑郁症和严重的社交焦虑症	触发性事件,触发性事件##疾病症状
即使在我的房间里，我也会戴上帽子	情绪反应,情绪反应##行为效应
我整天都在弹出Xanax试图麻痹疼痛，它工作了一点点，但一旦我下来，它就会崩溃两倍。	情绪反应,情绪反应##行为效应
我不知道如何与人沟通，我不知道如何保持关系	触发性事件,触发性事件##社会关系
但在我父亲去世后	触发性事件,触发性事件##社会关系
我感觉自己陷入了一个深深的黑洞	认知歪曲,认知歪曲##心理过滤
我被逮捕了无数次	认知歪曲,认知歪曲##放大和缩小
我还没有自杀的唯一原因是因为我的妈妈和兄弟。如果我没有它们，我早就死了。	认知歪曲,认知歪曲##情绪化推理
即使是他们的爱和支持也不足以让我活下去	情绪反应,情绪反应##情感效应,驳斥,驳斥##习惯性驳斥
我要么是那个自杀的人，要么是那个秃顶、20岁	认知歪曲,认知歪曲##非此即彼
看起来像一个猥亵儿童的人	认知歪曲,认知歪曲##乱贴标签
但我的精神疾病再一次破坏了每个人的事情	认知歪曲,认知歪曲##罪责归己/他
我害怕他们会死	认知歪曲,认知歪曲##放大和缩小
我的一个朋友给了我一个值得的谈话，他说世界不应该围着我转，这当然是对的	触发性事件,触发性事件##社会关系
我不应该控制他们，他们只是因为焦虑而说话	认知歪曲,认知歪曲##应该句式
尽管知道我的精神状态很脆弱，我最好的朋友还是决定离开	触发性事件,触发性事件##社会关系
你不能忘记焦虑问题，它们一直存在	驳斥,驳斥##习惯性驳斥
我哭着睡着了，今天一大早醒来，浑身发抖	情绪反应,情绪反应##行为效应
我内心的某个恶毒部分想让他们担心我	认知歪曲,认知歪曲##乱贴标签
我不知道你是怎么想的，但当我非常担心某人的时候，我是不会睡着的，直到找到他	认知歪曲,认知歪曲##情绪化推理
我现在又坐在咖啡馆旁边哭得稀里哗啦	情绪反应,情绪反应##行为效应
我总是在他们身边，但我从不觉得他们关心我	认知歪曲,认知歪曲##以偏概全
我有生以来第一次有了自杀的念头	情绪反应,情绪反应##情感效应
也许如果我自杀或重伤自己，他们最终会关心我	认知歪曲,认知歪曲##情绪化推理
我是个耻辱，大家都受够我了	认知歪曲,认知歪曲##乱贴标签
至少如果我自杀了，他们还会在乎	认知歪曲,认知歪曲##情绪化推理
又怕我的遗书给父母带来谴责	认知歪曲,认知歪曲##妄下结论
不断强调我选择死只是我自己的责任，与我父母的任何语言行动无关。	认知歪曲,认知歪曲##罪责归己/他
想推荐的孩子可能做不上下一任主席	认知歪曲,认知歪曲##妄下结论
被耍，但是不知道怎么还击	触发性事件,触发性事件##情感
但觉得自己真的好差	认知歪曲,认知歪曲##情绪化推理
很想逃避，想去死	情绪反应,情绪反应##行为效应
我在生活中做出了非常糟糕的决定，导致了我现在的样子	认知歪曲,认知歪曲##罪责归己/他
抑郁和自杀	情绪反应,情绪反应##行为效应
，我高中辍学了，还没考普通教育水平证书	触发性事件,触发性事件##学习工作
我能否通过考试，因为除了写作/英语部分，我在其他方面都很迟钝。我觉得自己很失败。	认知歪曲,认知歪曲##否定正面思考,认知歪曲,认知歪曲##妄下结论
他操纵我，	触发性事件,触发性事件##情感
崩溃	情绪反应,情绪反应##情感效应
我想离开，但这并不容易，原因有很多。	驳斥,驳斥##有效驳斥
我没有工作，	触发性事件,触发性事件##学习工作
我失去了所有支持我的人	触发性事件,触发性事件##社会关系,认知歪曲,认知歪曲##以偏概全
情绪低落	情绪反应,情绪反应##情感效应
我觉得自己很丑。	认知歪曲,认知歪曲##情绪化推理
自从我他妈这么沮丧，我就再也找不到好作品了。	认知歪曲,认知歪曲##情绪化推理
我只想死，	驳斥,驳斥##习惯性驳斥
觉得人生没有活着的任何理由	认知歪曲,认知歪曲##妄下结论
父母让我痛苦，生活让我压抑	触发性事件,触发性事件##情感
一切死气沉沉，毫无任何希望可言	认知歪曲,认知歪曲##以偏概全
活下去真的十分需	触发性事件,触发性事件##情感
那我就去死。	情绪反应,情绪反应##情感效应
六年级的时候就跳过一次楼	情绪反应,情绪反应##行为效应
当时我实在是对这种恶心的家庭感到绝望	触发性事件,触发性事件##生活,触发性事件,触发性事件##情感,认知歪曲,认知歪曲##否定正面思考
然后不过多久就纵身一跃。	情绪反应,情绪反应##行为效应
就读于一所不错的大学的计算机科学专业	触发性事件,触发性事件##学习工作
我的生活非常幸运，无论是经济上还是社会上	触发性事件,触发性事件##生活
然而，大约从六年级开始，我的抑郁就没有得到缓解。	触发性事件,触发性事件##疾病症状
不管我拥有什么，我都不开心	认知歪曲,认知歪曲##心理过滤
每天我都觉得自己为了生活付出了太多的精力，以至于在做事情的时候(比如社交或功课)，我发现有很多无法克服的障碍	触发性事件,触发性事件##生活
我的父母只会认为我很懒，我的抑郁症把我推入了一个想要自我放纵的循环;	认知歪曲,认知歪曲##心理过滤
然而，我觉得在我喜欢的事情中找不到乐趣	认知歪曲,认知歪曲##否定正面思考
我只是重复做这些事情，没有真正的情绪反应。	认知歪曲,认知歪曲##妄下结论
我不记得有哪一天我没有想过自杀	情绪反应,情绪反应##行为效应
我最后的告别	情绪反应,情绪反应##行为效应
我几乎没有机会拥有过去十年来我一直在努力实现的生活	触发性事件,触发性事件##生活
很明显，可视化是一派胡言。	认知歪曲,认知歪曲##以偏概全
一直负债累累。即使两次破产	触发性事件,触发性事件##生活
每次我尝试新事物想要摆脱困境，就会陷入困境	认知歪曲,认知歪曲##非此即彼
没有我，我不允许在经济上取得成功，	认知歪曲,认知歪曲##妄下结论
因为无论我多么想要，多么努力，我都不会成功。	认知歪曲,认知歪曲##妄下结论
其中很多都是我搞砸的，我再也无法从中恢复过来。	认知歪曲,认知歪曲##罪责归己/他
如果有合适的伴侣和适当的支持，我本可以取得伟大的成就。	认知歪曲,认知歪曲##妄下结论
我身边的人绝对没有办法阻止这一切—	认知歪曲,认知歪曲##妄下结论
咆哮，也许是发泄	情绪反应,情绪反应##行为效应
一个多月来，我一直感到非常沮丧，想自杀	情绪反应,情绪反应##情感效应
我的一个朋友约我出去，我们约会了一个星期，直到她和我分手	触发性事件,触发性事件##情感
从那以后，我一直想自杀或严重伤害自己	情绪反应,情绪反应##情感效应
他们都不希望我死，但我认为他们只是在撒谎，试图把我留在这里，这样他们就可以羞辱我，让我更痛苦，	认知歪曲,认知歪曲##否定正面思考
我只想……然后去另一个国家	驳斥,驳斥##有效驳斥
自从我被甩后，我就一直自残，以至于所有的伤口都会留下可怕的伤疤	情绪反应,情绪反应##行为效应
一个星期前，我在体育课的时候，我的腿被撞到了伤口	触发性事件,触发性事件##生活
我在网上订购了一个纸箱刀	情绪反应,情绪反应##行为效应
因为我不会成为每个人的负担	认知歪曲,认知歪曲##罪责归己/他
我很感激你这个宝贵的人花时间读了一些没用的东西	认知歪曲,认知歪曲##乱贴标签
我想结束这一切	情绪反应,情绪反应##情感效应
是一名高中二年级学生	触发性事件,触发性事件##学习工作
也没有一个女孩对我感兴趣	认知歪曲,认知歪曲##妄下结论
大多数人都把我当狗屎对待	认知歪曲,认知歪曲##情绪化推理
我有个很亲密的朋友会听我的	触发性事件,触发性事件##社会关系
但我现在觉得自己是多余的	认知歪曲,认知歪曲##非此即彼,认知歪曲,认知歪曲##乱贴标签
我没有吸引力	认知歪曲,认知歪曲##妄下结论
除了不给父母带来悲伤，我找不到继续活着的理由	认知歪曲,认知歪曲##否定正面思考
我感到孤独、丑陋、不受欢迎。	认知歪曲,认知歪曲##乱贴标签
我觉得下周我就拿把枪结束这一切	情绪反应,情绪反应##情感效应
今天早上上吊自杀，我再也受不了了	驳斥,驳斥##有效驳斥
无论我走到哪里，我都觉得自己不属于这里	认知歪曲,认知歪曲##情绪化推理
焦虑	触发性事件,触发性事件##疾病症状
当我向父母敞开心扉的那一刻，他们看着我就像我是个疯子一样。	触发性事件,触发性事件##社会关系
治疗毫无作用	认知歪曲,认知歪曲##以偏概全
我甚至不知道我为什么会在这个世界上	认知歪曲,认知歪曲##罪责归己/他
被当作一个生来就患有这种痛苦疾病的次等人对待。	认知歪曲,认知歪曲##乱贴标签
事情只会变得更糟。	认知歪曲,认知歪曲##以偏概全
我的生活就是人间地狱	认知歪曲,认知歪曲##乱贴标签
高度在一米五左右	认知歪曲,认知歪曲##放大和缩小
植物生长好快，园丁好懒	认知歪曲,认知歪曲##妄下结论
我没法确定是100%致死。	情绪反应,情绪反应##情感效应
去年我读了一个硕士课程	触发性事件,触发性事件##学习工作
我的论文也被实验室的拖延和我的团队成员毁了	认知歪曲,认知歪曲##妄下结论
因此，尽管我比我的大多数同学付出了更多的努力，但我正处于失败的边缘	认知歪曲,认知歪曲##情绪化推理
除此之外，我没有什么值得谈论的社交生活	触发性事件,触发性事件##社会关系
去年我女朋友死于癌症后	触发性事件,触发性事件##情感
我们国家的心理医生都是混蛋	认知歪曲,认知歪曲##乱贴标签
为什么我不该死?继续让自己难堪还有意义吗?	认知歪曲,认知歪曲##情绪化推理
我今年26岁，早就应该完成学业了	认知歪曲,认知歪曲##应该句式
我从来没有遇到过比“失败是成功的垫脚石”更糟糕的一句话	认知歪曲,认知歪曲##以偏概全
但是我正在失去一切，希望我很快也会失去我的生命	情绪反应,情绪反应##情感效应
我发现我无法毕业了。被大学开除了	触发性事件,触发性事件##学习工作
抽大麻被抓了	触发性事件,触发性事件##生活
我曾经的一丝希望也消失了	认知歪曲,认知歪曲##以偏概全
好像我之前的抑郁还不够严重似的	认知歪曲,认知歪曲##情绪化推理
我25岁，我的未来从我手中被夺走了	认知歪曲,认知歪曲##否定正面思考
所以我所能做的就是坐在这里恨自己	情绪反应,情绪反应##情感效应
我一个人，应付不了这一切	触发性事件,触发性事件##社会关系
我每天醒来都希望这一切快点结束	情绪反应,情绪反应##情感效应
我想刺死自己	情绪反应,情绪反应##情感效应
最近我的生活不太顺利	触发性事件,触发性事件##生活
我很冷漠，除了悲伤和沮丧，我什么也感觉不到	情绪反应,情绪反应##情感效应
我发出的每一个微小的笑声，我试图做出的每一个微笑，都是假的	认知歪曲,认知歪曲##否定正面思考
我的父母从来没有爱过我	认知歪曲,认知歪曲##以偏概全
我没有朋友，我搬到另一个城市后就离开了其他朋友	触发性事件,触发性事件##社会关系
我没有一段感情是成功的	触发性事件,触发性事件##情感
我知道这样的事情对那些甚至没有钱去最近的国家旅行的人来说永远不会有好的结果	认知歪曲,认知歪曲##否定正面思考
我只感到悲伤，我只听到侮辱和评判	情绪反应,情绪反应##情感效应
我正在慢慢地陷入精神病和精神分裂症	认知歪曲,认知歪曲##情绪化推理
我想结束我自己。我想把厨房里的每一粒药丸都吃得过量，我想在脖子上刺五刀，在死前被自己的血呛死，我想在脖子上系上套索，最后跳下去。	情绪反应,情绪反应##情感效应
我想重新开心起来，这是唯一的办法	驳斥,驳斥##习惯性驳斥
我在我讨厌的医学院读书	触发性事件,触发性事件##学习工作
我和父母吵了一架	触发性事件,触发性事件##生活
如果这就是生活，我宁愿死	认知歪曲,认知歪曲##情绪化推理
一直在与饮食失调作斗争	触发性事件,触发性事件##生活
和其他像我一样糟糕的人	认知歪曲,认知歪曲##乱贴标签
因为不管出于什么原因，我再也不能享受生活中的任何事情了	认知歪曲,认知歪曲##以偏概全
多年的虐待	触发性事件,触发性事件##生活
我想不出其他办法来解决我所处的困境，我尝试了很多方法	驳斥,驳斥##习惯性驳斥
在这个世界上，一切都是关于建立良好的关系和拍别人的马屁，这是你取得成功的方式	认知歪曲,认知歪曲##非此即彼
我真的不想融入这个社会	触发性事件,触发性事件##社会关系
我想自杀	情绪反应,情绪反应##情感效应
这些白痴	认知歪曲,认知歪曲##乱贴标签
我刚被我实习的那家公司的总裁解雇了	触发性事件,触发性事件##学习工作
今晚我要嗑药过量了	情绪反应,情绪反应##行为效应
我莫名其妙地把它搞砸了，他竟然当着整个软件团队的面对我大喊大叫，说我做错了什么，骂了我一个多小时，还一直摆出一副居高临下的样子，显然认为我太蠢了，无法理解这些概念	触发性事件,触发性事件##学习工作
但我一直有一点不安全感，那就是我上的大学非常低端(在一个低收入城市，录取率很高)	触发性事件,触发性事件##学习工作
即使有4.0分，我也跟不上正常人	认知歪曲,认知歪曲##妄下结论
我觉得自己毫无价值	认知歪曲,认知歪曲##乱贴标签
我非常清楚这两件事，在我的领域里，人们看不起我	认知歪曲,认知歪曲##以偏概全
我显然不适合和聪明人相处	认知歪曲,认知歪曲##妄下结论
永远不会足够	认知歪曲,认知歪曲##妄下结论
软件团队在没有我的情况下会完成更多的工作，我总是把事情搞砸，需要帮助，如果我不在，他们会更快	认知歪曲,认知歪曲##罪责归己/他
他们甚至不喜欢我在他们身边，我看得出来，他们对我的存在都很生气，尽管我尽了最大的努力不去惹他们生气	触发性事件,触发性事件##社会关系
我受够了做一个失败者	认知歪曲,认知歪曲##乱贴标签
但这只是向大家展示了我是一个多么愚蠢的黑人垃圾	认知歪曲,认知歪曲##乱贴标签
我永远也达不到他们那样的人	认知歪曲,认知歪曲##妄下结论
我也时常会想到自杀	情绪反应,情绪反应##情感效应
我估计我应该会烧炭自杀吧！先吃点安眠药，然后就像睡着了一样……	认知歪曲,认知歪曲##情绪化推理
为什么想要自杀，是因为对未来的生活无望	认知歪曲,认知歪曲##否定正面思考
为什么还没有行动，是因为顾念家里的父母	触发性事件,触发性事件##社会关系
第一次尝试自杀是在小学	情绪反应,情绪反应##行为效应
从初中开始一直有“活着无意义也无趣”的想法	认知歪曲,认知歪曲##妄下结论
大学入学心理测试被学校划入异常群体	触发性事件,触发性事件##学习工作
详细地计划过一次自杀	情绪反应,情绪反应##行为效应
之后我给自己设定了一个“如果XX就死”的条件	认知歪曲,认知歪曲##妄下结论
她又走了。今晚我要结束了	触发性事件,触发性事件##情感
我今晚要自杀了	情绪反应,情绪反应##行为效应
因为我真的没有理由再呆在这里了	认知歪曲,认知歪曲##妄下结论
在我需要的时候，她是我的拐杖，她帮助我度过了一切，我也帮助了她。	触发性事件,触发性事件##情感
我当然是他们鄙视的疯狂前任	认知歪曲,认知歪曲##乱贴标签
但她撒谎了。很多。我原谅了她，我让她进来，我让她欺负我但她会突然一周有一天说她不想和我有任何关系。	触发性事件,触发性事件##情感
可能熬不过今晚了	认知歪曲,认知歪曲##妄下结论
要不是因为你，我早就放弃了	认知歪曲,认知歪曲##情绪化推理
我不再感到痛苦，悔恨，悲伤，愤怒，或任何东西。我已经麻木了	认知歪曲,认知歪曲##心理过滤
我一直在考虑自杀，拼命寻找活下去的理由	驳斥,驳斥##有效驳斥
想要帮我就像游过大西洋一样根本不可能。	认知歪曲,认知歪曲##妄下结论
自杀热线今天挂了我两次因为我他妈是个废柴	认知歪曲,认知歪曲##乱贴标签
我他妈的一文不值	认知歪曲,认知歪曲##乱贴标签
我割了自己20多刀	情绪反应,情绪反应##行为效应
我试图自杀	情绪反应,情绪反应##行为效应
下了地狱因为我不认为情况会变得更糟，而且情况越来越糟	认知歪曲,认知歪曲##情绪化推理
我哭个不停我他妈算哪门子男人?	认知歪曲,认知歪曲##乱贴标签
我没有朋友。	触发性事件,触发性事件##社会关系
我身边的是几个月来一直困扰我的肺炎	触发性事件,触发性事件##疾病症状
但我曾经把所有的想法都写在笔记本上	触发性事件,触发性事件##生活
我知道生活不应该对每个人都公平，但我总是把别人放在自己前面。	认知歪曲,认知歪曲##乱贴标签
对不起，妈妈，我太爱你了，我知道我会让你哭，但对不起，我做不到	驳斥,驳斥##有效驳斥
我就是不能。我不能让你失望。我爱我自己，	驳斥,驳斥##有效驳斥
我最不想做的就是上吊自杀，让找到我的人受到精神创伤	驳斥,驳斥##有效驳斥
自杀。	情绪反应,情绪反应##行为效应
我交往了一年多的女朋友要离开我了	触发性事件,触发性事件##情感
我和家人疏远了	触发性事件,触发性事件##社会关系
我已经辞去了我的工作	触发性事件,触发性事件##学习工作
我拥有的不多，现在我觉得我正在失去一切。	认知歪曲,认知歪曲##心理过滤
我最好的朋友兼室友自杀了	触发性事件,触发性事件##社会关系
我和他一样，在门把手上系了一条皮带，然后坐了下来，直到我几乎昏过去	情绪反应,情绪反应##行为效应
如果我死了，会有一个葬礼，我不想给任何人带来不便	驳斥,驳斥##有效驳斥
我再也找不到自己的价值了	认知歪曲,认知歪曲##以偏概全
我完全活在自己的脑子里，我不能再这样做了	驳斥,驳斥##有效驳斥
但最近几个月我感觉真的很糟糕	情绪反应,情绪反应##情感效应
我已经和焦虑斗争了5年了	触发性事件,触发性事件##疾病症状
它结束了我美好的职业生涯	触发性事件,触发性事件##学习工作
我交了一些很好的朋友	触发性事件,触发性事件##社会关系
我所做的一切都是因为我的问题而破坏了我们的友谊	认知歪曲,认知歪曲##非此即彼
我仍然很确定我不会结束我的生命，尽管我的想法，因为我不想让我的朋友和家人经历，但我真的很担心	驳斥,驳斥##有效驳斥
我觉得如果这就是我现在的感觉，情况会变得更糟。	认知歪曲,认知歪曲##情绪化推理
我搬到了别的州	触发性事件,触发性事件##生活
和我妈妈和继父住在一起	触发性事件,触发性事件##社会关系
努力完成大学学业	触发性事件,触发性事件##学习工作
每次我开始上学，	触发性事件,触发性事件##学习工作
我都不得不因为经济原因而停下来。	触发性事件,触发性事件##生活
我只是觉得很失败，我已经26岁了，还没有戒酒会	认知歪曲,认知歪曲##非此即彼
我感觉被背叛了，生活还是没有好转。	认知歪曲,认知歪曲##心理过滤
只是更多的失望和挫折	认知歪曲,认知歪曲##情绪化推理
我就结束它。	情绪反应,情绪反应##行为效应
我想自杀	情绪反应,情绪反应##情感效应
我的妈妈爱我，我爱她，我有爱我的朋友，我有一个很棒的男朋友，我们也彼此相爱	触发性事件,触发性事件##情感
我的妈妈爱我，我爱她，我有爱我的朋友，我有一个很棒的男朋友，我们也彼此相爱。	触发性事件,触发性事件##社会关系
我上的是法学院，没有那么难，也没有那么大的压力	触发性事件,触发性事件##学习工作
但我发现自己每天都在哭。	触发性事件,触发性事件##疾病症状
我甚至在公共场合也会哭	触发性事件,触发性事件##疾病症状
有几次我想自杀	情绪反应,情绪反应##情感效应
但我退缩了，主要是因为我妈妈和我的猫。	驳斥,驳斥##有效驳斥
我试着保持积极，告诉自己我有很多活下去的理由，但这似乎行不通。	认知歪曲,认知歪曲##否定正面思考
尝试做新的事情，寻找新的爱好，分散自己的注意力，这样我就不会去想不好的事情，但是没有什么奏效，我觉得自己每天都在变得更糟。	认知歪曲,认知歪曲##心理过滤
我甚至不知道如何描述我的感受，就像悲伤和沮丧	触发性事件,触发性事件##疾病症状
当我停止哭泣，放松我感到累了	触发性事件,触发性事件##疾病症状
我仍然每天上学，吃饭，做我必须做的正常事情	触发性事件,触发性事件##生活
所以我认为我并没有那么糟糕，	驳斥,驳斥##有效驳斥
但我越想越觉得结束我的生命更有意义。	情绪反应,情绪反应##情感效应
我和丈夫今年很早就分居了	触发性事件,触发性事件##社会关系
我遇到了一个只说不做的男人	触发性事件,触发性事件##情感
我一生中有过两次堕胎和一次小产，我不想再经历一次	触发性事件,触发性事件##生活
我有慢性抑郁症	触发性事件,触发性事件##疾病症状
我所能想到的就是杀死我自己和我的孩子	情绪反应,情绪反应##情感效应
我想这对每个人来说都是最好的解决办法。	认知歪曲,认知歪曲##情绪化推理
我觉得如果我跳楼(我最喜欢的自杀方式)，我的丈夫、我的女儿(我和我现在分居的丈夫有一个孩子)、孩子和我自己都会有更好的未来/结果。	认知歪曲,认知歪曲##妄下结论
我不知道，我脑子不清楚，什么事都做不好。	认知歪曲,认知歪曲##心理过滤
我被同事欺负，精神上受到折磨。	触发性事件,触发性事件##情感
我在许多研究项目中失败了，因此受到了严重的欺负。	认知歪曲,认知歪曲##妄下结论
除了上班和健身房，没有任何社交活动	触发性事件,触发性事件##社会关系
从来没有女朋友，也没有和异性有过任何形式的身体接触	触发性事件,触发性事件##情感
最糟糕的是我的工作和所有失败的项目。	认知歪曲,认知歪曲##以偏概全
我活着的唯一理由是我的家人和弟弟	驳斥,驳斥##有效驳斥
我不想让他们在我死的时候感到悲伤。	驳斥,驳斥##有效驳斥
没有希望了	认知歪曲,认知歪曲##妄下结论
我不能停止割伤自己	认知歪曲,认知歪曲##妄下结论
戒不掉毒品。我就是不能。	认知歪曲,认知歪曲##否定正面思考
我让我男朋友支持我，但他没有	触发性事件,触发性事件##社会关系
今天是我戒毒的第一天。	触发性事件,触发性事件##疾病症状
我感觉很糟糕	触发性事件,触发性事件##情感
我有这种冲动。我想自残。我想抽烟	情绪反应,情绪反应##情感效应
我不会从低谷中走出来。没有比以前更深，但我的能量和生存的意志都消失了。	认知歪曲,认知歪曲##妄下结论
我的内心空虚得像死了一样	认知歪曲,认知歪曲##乱贴标签
单身	触发性事件,触发性事件##社会关系
失业	触发性事件,触发性事件##学习工作
没有朋友	触发性事件,触发性事件##社会关系
绝对，毁灭性的心碎	触发性事件,触发性事件##情感
我可能有什么问题，因为我从12岁起就没能交到自己的朋友	认知歪曲,认知歪曲##情绪化推理
无论我付出了多少爱，无论我多么关心别人，没有人为我做过这些。	认知歪曲,认知歪曲##心理过滤
绝望至极	触发性事件,触发性事件##情感
现在我正在经历分手	触发性事件,触发性事件##社会关系
一路上我遇到的所有了不起的人都和他在一起	认知歪曲,认知歪曲##放大和缩小
我自己的姐妹们都太专注于她们自己的事了，根本不在乎我在经历什么。	认知歪曲,认知歪曲##否定正面思考
现在我坐在这里，纠结着要不要结束这一切	情绪反应,情绪反应##情感效应
我现在觉得活着最糟糕了，而死亡似乎没有比这更糟糕的了	认知歪曲,认知歪曲##妄下结论
我一直在与焦虑和抑郁作斗争	触发性事件,触发性事件##疾病症状
一年前我试图过量服用	情绪反应,情绪反应##行为效应
我因为想自杀而被送进了病房	情绪反应,情绪反应##情感效应
一两个月后，我被诊断出患有身体畸形症，这让我每天都很难受。	触发性事件,触发性事件##疾病症状
没有生活，没有朋友我也交不到朋友	认知歪曲,认知歪曲##妄下结论
我是个怪物	认知歪曲,认知歪曲##乱贴标签
最糟糕的是，没有人理解我的感受	认知歪曲,认知歪曲##否定正面思考
我一直在坚持，情况越来越糟	认知歪曲,认知歪曲##否定正面思考
我什么都做不了，我浪费了我的生命直到成年	认知歪曲,认知歪曲##情绪化推理
我只想自杀	情绪反应,情绪反应##情感效应
我的家人鄙视我，没有人知道我的存在	认知歪曲,认知歪曲##妄下结论
我是如此的孤独、可悲和恶心	认知歪曲,认知歪曲##乱贴标签
如果我在这个世界上呆着，我将孤独地活着，孤独地死去。	认知歪曲,认知歪曲##妄下结论
我一直感觉很糟糕	触发性事件,触发性事件##情感
我再也看不到隧道尽头的光明了	认知歪曲,认知歪曲##妄下结论
我很想念他。	触发性事件,触发性事件##情感
我正在从强奸中恢复	触发性事件,触发性事件##生活
去年我非常悲伤和沮丧。现在我只觉得麻木和疏离	触发性事件,触发性事件##情感
我唯一的感觉就是痛苦。	触发性事件,触发性事件##情感
我的生活一直都是噩梦。	认知歪曲,认知歪曲##以偏概全
我总是觉得不舒服。我没有胃口	触发性事件,触发性事件##疾病症状
我只想要快乐。	驳斥,驳斥##习惯性驳斥
我想过美好的生活，但我做不到	认知歪曲,认知歪曲##否定正面思考
很明显，这就是我的生活而我的生活就是一场噩梦。	认知歪曲,认知歪曲##妄下结论
我开始想死了。我好害怕	情绪反应,情绪反应##情感效应
我只想要幸福的生活	驳斥,驳斥##习惯性驳斥
下个月我生日的时候。就是我离开这个世界的那一天	情绪反应,情绪反应##情感效应
在过去的4年里一直患有抑郁症	触发性事件,触发性事件##疾病症状
我无法摆脱它	认知歪曲,认知歪曲##否定正面思考
家里甚至没有人关心我的存在	触发性事件,触发性事件##社会关系
我厌倦了我的方式，	情绪反应,情绪反应##情感效应
只有永久的沉默可以。	认知歪曲,认知歪曲##妄下结论
这两年，倾向就更加严重了，拿刀跳河等等，都尝试过	情绪反应,情绪反应##行为效应
终归不就是对抗体量比自己大无数倍的人或者事，往往力不从心一败涂地，让我由衷有一种怀疑自己，渐渐厌恶自己的感觉	认知歪曲,认知歪曲##放大和缩小
对抗体量比自己大无数倍的人或者事	触发性事件,触发性事件##生活
我出生在极度贫困的家庭。有一段时间，我的父亲和他的兄弟姐妹们不得不在运输时收集掉落的麦粒作为食物。但是当我出生的时候，我的父亲在我母亲的帮助下努力工作，每天给我两次食物。	触发性事件,触发性事件##生活
我小时候是个不守规矩的男孩。我到处都是。尖叫,攻击等等，做各种疯狂的事情。	触发性事件,触发性事件##生活
由于缺乏教育，我的父母不知道什么更好，他们也负担不起我的任何医疗费用。因为他们认为我只是一个普通的混蛋，他们开始对我进行身体上的惩罚。	触发性事件,触发性事件##生活
我妈妈无数次地在我的眼睛和喉咙里放凉粉，直到13岁	触发性事件,触发性事件##生活
我的学校开始变得越来越糟糕，因为有很多恶霸欺负我。	触发性事件,触发性事件##学习工作
我曾试图自杀，我曾试图从学校大楼上跳下去	情绪反应,情绪反应##情感效应
还有就是爷爷奶奶的去世，我的外祖父和我的叔叔。他们和我非常亲近，在那之前，他们是唯一会送我玩具之类的好东西的人，1美元的玩具对我来说是一笔财富。	触发性事件,触发性事件##社会关系
后来，成年后，我发现我有多动症，因为我的过去，我有严重的抑郁、焦虑和焦虑;创伤后应激障碍。	触发性事件,触发性事件##疾病症状
但我的父母仍然很努力地工作，供我和我的弟弟上了工程学院(我花了10年的时间上了4年的大学)。现在我是一名工程师，由于心理问题，我没有亲人	触发性事件,触发性事件##学习工作
但是我有一个朋友，她和我一样有过不好的童年经历。她住在地球的另一端。我以前每天都和她聊天。但是她现在忙于学业和工作，没有时间和我说话。	触发性事件,触发性事件##社会关系
再也没有人爱我了	认知歪曲,认知歪曲##妄下结论
我已经没有爱我的人了，没有了	认知歪曲,认知歪曲##妄下结论
我一无所有，一无所有	认知歪曲,认知歪曲##否定正面思考
昨天，我从公司拿了些氰化钾。过几天我可能会自杀。	情绪反应,情绪反应##行为效应
家里人催着我相亲结婚	触发性事件,触发性事件##生活
大家看不到我的内心，是那样的翻江倒海，像要被什么吞噬掉。甚至于当我要描述这些年的事件时，我都觉得自己是那样的混乱的	认知歪曲,认知歪曲##妄下结论
我想，是时候要离开了。	情绪反应,情绪反应##情感效应
我为什么不能自杀呢?	认知歪曲,认知歪曲##否定正面思考
我没有朋友或家人可以说话(除了我疯狂的爸爸)，我有一个虐待我的继父，我在家里和学校都被欺负了好几年	触发性事件,触发性事件##生活
我一直非常沮丧，但现在我意识到我真的没有活下去的理由。	情绪反应,情绪反应##情感效应
我没有地方放松和学习，所以我最终辍学了，现在我的gcse考试搞砸了，所以我不能上好六年级。	触发性事件,触发性事件##学习工作
现在这不会发生了，我最终会无家可归，所以谁能给我一个理由为什么我不应该自杀。	认知歪曲,认知歪曲##否定正面思考,驳斥,驳斥##习惯性驳斥
我最终会无家可归	认知歪曲,认知歪曲##妄下结论
所以谁能给我一个理由为什么我不应该自杀	认知歪曲,认知歪曲##应该句式
我计划在几天内从悬崖上跳下来(我会确保它足够高)，这样我失败的可能性为0%。	情绪反应,情绪反应##行为效应
我很孤单。我已经厌倦了尝试。	情绪反应,情绪反应##情感效应
我过去有过自杀企图。	情绪反应,情绪反应##行为效应
简单地说，如果我再次崩溃，我就不会回来了。	认知歪曲,认知歪曲##非此即彼
我毁了太多的后路，他们现在对我更失望，而不是真正关心我。	认知歪曲,认知歪曲##否定正面思考
我选择生或死。	认知歪曲,认知歪曲##非此即彼
但说实话，我不认为我有能力生活。	认知歪曲,认知歪曲##否定正面思考
那我就只有一个选择了。	认知歪曲,认知歪曲##非此即彼
周日自杀。	情绪反应,情绪反应##行为效应
我比以往任何时候都更想死。我已经没有活下去的理由了。	认知歪曲,认知歪曲##非此即彼
我已经没有活下去的理由了。	认知歪曲,认知歪曲##妄下结论
我失去了一个非常亲密的好朋友，失去了很多朋友，有非常严重的精神问题，失去了我生命中的挚爱，我毁掉了大多数关系，比如家庭，朋友。	触发性事件,触发性事件##社会关系,触发性事件,触发性事件##生活,触发性事件,触发性事件##情感
从中学开始，我失去了大部分的朋友	触发性事件,触发性事件##社会关系
从13岁起，我就幻想着自杀	触发性事件,触发性事件##疾病症状
我他妈的恨死自己了我他妈的怎么能把事情搞砸。	认知歪曲,认知歪曲##心理过滤
我真的很崩溃，	情绪反应,情绪反应##情感效应
我得到了某种触发，所以我把自己关起来，一整年都无视班上的每个人	触发性事件,触发性事件##疾病症状
真的很焦虑	情绪反应,情绪反应##情感效应
真的想自杀。	情绪反应,情绪反应##行为效应
每天都是他妈的地狱般的生活，	认知歪曲,认知歪曲##以偏概全
分手后，我告诉自己，我要振作起来，找回我的幸福，	驳斥,驳斥##有效驳斥
但每天晚上我都陷得越来越深，我觉得不值得再这样下去了。	认知歪曲,认知歪曲##放大和缩小
我真他妈讨厌我自己	触发性事件,触发性事件##情感
我的一切都被夺走了	认知歪曲,认知歪曲##以偏概全
我有边缘性抑郁，非常严重的抑郁症，社交焦虑和创伤后应激障碍。	触发性事件,触发性事件##疾病症状
我决定在星期天结束我的生命。	情绪反应,情绪反应##行为效应
唯一的感觉就是空虚和痛苦。	情绪反应,情绪反应##情感效应
因为我有心理健康问题，比如抑郁症、创伤后应激障碍、BPD、焦虑。	触发性事件,触发性事件##疾病症状
我什么都做不好	认知歪曲,认知歪曲##以偏概全
我觉得自己很没用，很失败。	认知歪曲,认知歪曲##否定正面思考
我决定永远结束我的生命(我之前曾尝试过几次自杀，但都失败了)。	情绪反应,情绪反应##行为效应
我很快就要自杀了，	情绪反应,情绪反应##行为效应
我已经抑郁4年了。	触发性事件,触发性事件##疾病症状
根本没有朋友	触发性事件,触发性事件##社会关系
因为我的情绪太过疲惫，而且感觉有一种无边无际的黑暗让我感到沉重	触发性事件,触发性事件##疾病症状
我变成了一个滥交的恶魔。	认知歪曲,认知歪曲##乱贴标签
我最好还是离开这里。	认知歪曲,认知歪曲##否定正面思考
我不能忍受做这样一个混蛋和水蛭。	认知歪曲,认知歪曲##乱贴标签
我这辈子都搞砸了	认知歪曲,认知歪曲##以偏概全
我想不出任何一个时刻我可以说:“嘿，那一次我不是一个十足的白痴!”	认知歪曲,认知歪曲##以偏概全
是我的错。	认知歪曲,认知歪曲##罪责归己/他
我想自杀的原因主要是	情绪反应,情绪反应##行为效应
自我否定	认知歪曲,认知歪曲##罪责归己/他
对感情失望，爱而不得	触发性事件,触发性事件##情感
现在真的筋疲力尽。感觉好累好累，对生活，他人和世界都充满了绝望。	情绪反应,情绪反应##情感效应
磨刀石到了之后，费力把短剑开了刃，拿着短剑在心脏处比划着下手，可是比划来比划去只留下几个浅浅的伤口，为什么会这么痛！剑尖刺到皮肤感觉到疼就完全下不去手。	情绪反应,情绪反应##行为效应
可我真的觉得我把自己的人生过得好失败啊。	认知歪曲,认知歪曲##否定正面思考
没有一个交心的朋友	触发性事件,触发性事件##社会关系
读书也不好好读，	触发性事件,触发性事件##学习工作
不会为人处世	触发性事件,触发性事件##社会关系
觉得自己的未来没有一点希望。	认知歪曲,认知歪曲##否定正面思考
想赶快死去。	情绪反应,情绪反应##行为效应
我有自杀倾向好几年了。	触发性事件,触发性事件##疾病症状
这学期我退了三门课，	触发性事件,触发性事件##学习工作
我已经对自己很失望了	情绪反应,情绪反应##情感效应
我失去了我爱的女孩，	触发性事件,触发性事件##情感
我现在很害怕给他打电话，如果我不打电话，我实际上就无家可归了，但是如果我没有无家可归，如果我真的死了，这是一个加分项，我就不用再担心所有的压力了。	认知歪曲,认知歪曲##否定正面思考
我得了疱疹病毒1型。	触发性事件,触发性事件##疾病症状
我真的在考虑今晚结束我的生命。	情绪反应,情绪反应##行为效应
我有一段长期的，一夫一妻制的关系。	触发性事件,触发性事件##生活
在一起一年后，我的生殖器感染了hsv - 1。	触发性事件,触发性事件##疾病症状
他去年12月和我分手了，现在又开始了一段新的恋情。	触发性事件,触发性事件##生活
他背叛了我，也背叛了他现在的女朋友。	触发性事件,触发性事件##情感
我被玷污了，让人恶心。	认知歪曲,认知歪曲##非此即彼
我现在注定要过一种没有性和爱的生活。	认知歪曲,认知歪曲##以偏概全
我看了Reddit上的帖子，一遍又一遍地提醒我，我现在有多没用，因为我有永久性的性病。	认知歪曲,认知歪曲##乱贴标签
然而我的生命结束了。	认知歪曲,认知歪曲##情绪化推理
如果我余生都要一个人过，那活着就没有意义了。	认知歪曲,认知歪曲##以偏概全
我只是觉得太累了。	触发性事件,触发性事件##学习工作
我会很开心，我不会那么冷漠，我不会感觉麻木。	触发性事件,触发性事件##情感
我走得越远，感觉越凄凉。	情绪反应,情绪反应##情感效应
我总是听人说，我的人生已经走到了一个很好的阶段。	触发性事件,触发性事件##生活
但也许我很痛苦或其他什么。	触发性事件,触发性事件##情感
我终于有了自己的公寓	触发性事件,触发性事件##生活
我搬进来的时候从来没有请过朋友和父母来我家。	触发性事件,触发性事件##社会关系
我终于得到了升职，	触发性事件,触发性事件##学习工作
我必须填写没完没了的excel表格	触发性事件,触发性事件##学习工作
我只是觉得自己像个混蛋。	认知歪曲,认知歪曲##乱贴标签
我想帮忙，教他们一些东西，但没人在乎。	触发性事件,触发性事件##社会关系
对呼叫中心没有热情	触发性事件,触发性事件##情感
每周50小时的强制性工作和持续的轰炸让我感到压力很大。我的手机总是在我没有工作的那一天响个不停。我觉得即使我不在那里，我所做的一切都是工作。	触发性事件,触发性事件##学习工作
我有一辆车	触发性事件,触发性事件##生活
现在我不能开了，还得担心保险。	触发性事件,触发性事件##生活
即使我投了那么多钱，我也付不起房租或买食物等。	触发性事件,触发性事件##生活
我对自己感到厌恶。	情绪反应,情绪反应##行为效应
而我却觉得自己不够好，因为我觉得自己在生活中没有完成足够的“里程碑”	驳斥,驳斥##习惯性驳斥
因为我觉得自己在生活中没有完成足够的“里程碑”。	触发性事件,触发性事件##学习工作
每个人都说我会成功，但我总是担心，如果我做不到，人们会把我看得更糟。	认知歪曲,认知歪曲##否定正面思考
我并不痴迷于别人的事情，但我觉得不能和同龄人处于同一“水平”是很糟糕的。	认知歪曲,认知歪曲##以偏概全
我只是觉得我已经给了它很多时间，生活仍然感觉糟糕和灰色	认知歪曲,认知歪曲##放大和缩小
我已经厌倦了激励自己，认为事情会变得更好，或者最终会改变，但它只会变得更糟，或者保持同样的糟糕水平。	认知歪曲,认知歪曲##妄下结论
还是放弃吧。我跑得还可以。	认知歪曲,认知歪曲##情绪化推理
我一直在努力工作，努力把我的车还清。	触发性事件,触发性事件##生活
现在我觉得我又回到了谷底，我只想放弃。	认知歪曲,认知歪曲##心理过滤,情绪反应,情绪反应##情感效应
十年前我放弃了生活。	触发性事件,触发性事件##生活
是疲劳。	触发性事件,触发性事件##生活
从学校辍学去工作，在经济上维持他们的生活。	触发性事件,触发性事件##学习工作
从学校辍学去工作，在经济上维持他们的生活。我煮熟的。清洁。我管理我们的生活。当他们喝醉的时候。抑郁了。	触发性事件,触发性事件##生活
因为我爱他们。	触发性事件,触发性事件##情感
我总是责怪自己在喝醉的时候没有处理好他们。	认知歪曲,认知歪曲##罪责归己/他
我在各个方面都支持他，但总是不够好。	认知歪曲,认知歪曲##否定正面思考
我对他们大喊大叫。	情绪反应,情绪反应##情感效应
直到今天，那种屈服的感觉仍然是我记忆中最美好的情绪之一。	情绪反应,情绪反应##情感效应
但我现在有家人了。我有朋友。有人需要我。	触发性事件,触发性事件##社会关系
我发现对付生活最好的办法就是与它断绝关系。	认知歪曲,认知歪曲##妄下结论,认知歪曲,认知歪曲##情绪化推理
如果我不能达到每个人的期望，我会让事情变得更糟。	认知歪曲,认知歪曲##否定正面思考,认知歪曲,认知歪曲##妄下结论
我让生活变得艰难。	认知歪曲,认知歪曲##罪责归己/他
当这种情况发生时，我觉得自己毫无价值。别再想我自己了。	认知歪曲,认知歪曲##以偏概全,认知歪曲,认知歪曲##情绪化推理
我并没有真正感到快乐。	认知歪曲,认知歪曲##情绪化推理
当有人想进来时，我会下意识地把他们推开。	情绪反应,情绪反应##行为效应
我只是坐在这里，在我的大脑里腐烂。	认知歪曲,认知歪曲##情绪化推理
最近这些天我将会自杀，但我太贱了。	情绪反应,情绪反应##行为效应
我还得参加ACT考试。	触发性事件,触发性事件##学习工作
我不够聪明，不能胜任高薪的工作。	认知歪曲,认知歪曲##乱贴标签
我不够聪明，不能胜任高薪的工作。我可能一辈子都只能拿最低工资了。	认知歪曲,认知歪曲##情绪化推理
我可能一辈子都只能拿最低工资了。	认知歪曲,认知歪曲##妄下结论
在我的州买枪并不难所以等我25岁的时候，我就要结束我那该死的生活了。	情绪反应,情绪反应##行为效应
我割伤了自己，	情绪反应,情绪反应##行为效应
它曾经让我感到寒冷，但我现在什么都感觉不到了。	情绪反应,情绪反应##情感效应
如果我继续活下去，我将无家可归。	认知歪曲,认知歪曲##妄下结论,认知歪曲,认知歪曲##情绪化推理
被诊断患有双相情感障碍已经两年了	触发性事件,触发性事件##疾病症状
我已经酗酒六年了	情绪反应,情绪反应##行为效应
我的大部分青春都在远离一切人和事。	触发性事件,触发性事件##社会关系
这是我记事以来第一次有一个我爱的人，我和家人很亲近	触发性事件,触发性事件##社会关系
我还是比以前更痛苦了。	情绪反应,情绪反应##情感效应
最近我的狂躁症反复发作。	触发性事件,触发性事件##疾病症状
我一直在不停地喝酒，并服用过量的药物，看看它是否会意外地杀死我。	情绪反应,情绪反应##行为效应
我想把我的生活搞砸，这样我就什么都没有了，然后自杀。	情绪反应,情绪反应##行为效应
不管我看起来有多开心，我都觉得我的内心在腐烂。这一切似乎都毫无意义。	认知歪曲,认知歪曲##心理过滤
到现在已经两次试图自杀。	情绪反应,情绪反应##行为效应
我只是在等着我的鲁莽害死我，或者把我爱的一切都推开这样我就不用担心那些人了。	认知歪曲,认知歪曲##情绪化推理
如果我不尽快结束这段感情，我害怕自己会像她一样。	认知歪曲,认知歪曲##非此即彼,认知歪曲,认知歪曲##妄下结论,认知歪曲,认知歪曲##情绪化推理
我不想再活了。	触发性事件,触发性事件##情感
做一些简单的事情，比如刷牙和洗澡，变得越来越难了。	认知歪曲,认知歪曲##情绪化推理
我唯一想要的女孩和我不一样。	触发性事件,触发性事件##情感
我的家人认为我是个游手好闲的人	认知歪曲,认知歪曲##乱贴标签
我的家人认为我是个游手好闲的人，打算不再资助我。	触发性事件,触发性事件##社会关系
我没有人生方向，高中也没毕业。	触发性事件,触发性事件##生活
高中也没毕业。	触发性事件,触发性事件##学习工作
我不认为我能养活自己。	触发性事件,触发性事件##情感
最近我越来越想结束我的生命	情绪反应,情绪反应##行为效应
最近我越来越想结束我的生命，但我不想对我的朋友和家人那样做，我也害怕自己会搞砸自杀企图。	驳斥,驳斥##有效驳斥
精神上的痛苦比我所感受到的任何身体上的痛苦都要痛。	认知歪曲,认知歪曲##妄下结论
我不能再活下去了，每天都充满了痛苦。	触发性事件,触发性事件##情感
因为我知道真相是……没有人在乎，没有人真正在乎任何人	认知歪曲,认知歪曲##妄下结论
显然，没有其他人，我们就不会生活在这个资本主义的地狱里。	认知歪曲,认知歪曲##妄下结论,认知歪曲,认知歪曲##情绪化推理
如果我不能照顾好自己，那么没有人会照顾好自己，如果我今天不自杀，那么我很可能会因为营养不良或撞上汽车或其他什么原因而意外自杀，因为我既没用又愚蠢。	认知歪曲,认知歪曲##情绪化推理
因为我既没用又愚蠢。	认知歪曲,认知歪曲##乱贴标签
在一天结束的时候，我在这个星球上的存在是毫无意义的，空虚的，毫无意义的，可怜的。	认知歪曲,认知歪曲##情绪化推理
我的生活将被遗忘，我所有的希望、梦想、感情和欲望将不再存在。	认知歪曲,认知歪曲##妄下结论,认知歪曲,认知歪曲##情绪化推理
生活毫无意义，	认知歪曲,认知歪曲##情绪化推理
生活毫无意义，我和我的伴侣、他们的兄弟姐妹以及他们的兄弟姐妹住在我讨厌的房子里。	触发性事件,触发性事件##生活
我和我的伴侣、他们的兄弟姐妹以及他们的兄弟姐妹住在我讨厌的房子里。	触发性事件,触发性事件##社会关系
因为我和他们(我的伴侣)的兄弟姐妹身体不好	触发性事件,触发性事件##疾病症状
现在我的伴侣有严重的心理健康问题	触发性事件,触发性事件##疾病症状
所以他们不愿意做任何家务，他们说他们无法帮助我处理情绪，也无法在我需要的时候给予我真正的关爱。	触发性事件,触发性事件##生活,触发性事件,触发性事件##情感
每个房间都有垃圾桶，我仍然会捡每个人的垃圾。我每天都得从每个房间收拾盘子。我每天卸盘子和洗碗。我打扫柜台，倒垃圾/堆肥/回收垃圾，打扫房子，去杂货店买东西，洗衣服，打扫其他东西，给每个人做午餐(伴侣现在要去做密集门诊咨询，兄弟姐妹去上学，他们的伴侣去工作)，	触发性事件,触发性事件##生活
同时还要处理我严重的疼痛	触发性事件,触发性事件##疾病症状
同时还要处理我严重的疼痛(明天要扫描可能的佩吉特骨病)，网上作业和预约。	触发性事件,触发性事件##学习工作
我得不到伴侣的爱或支持，因为他们“状态不好”。	触发性事件,触发性事件##生活
我他妈觉得自己像个女仆。	认知歪曲,认知歪曲##乱贴标签
因为我的家人虐待我，我也没有朋友。	触发性事件,触发性事件##社会关系,触发性事件,触发性事件##生活
这种生活不值得过	认知歪曲,认知歪曲##情绪化推理
没有人可以说话	触发性事件,触发性事件##情感
27年来，我一直在漂泊	触发性事件,触发性事件##生活
这种事不会发生在我这样的人身上	认知歪曲,认知歪曲##妄下结论
决定自杀来结束痛苦和不满	情绪反应,情绪反应##情感效应
我开始加速，想要撞车	情绪反应,情绪反应##行为效应
我一生中大部分时间都有自杀的念头，	情绪反应,情绪反应##情感效应
我觉得我的身体想把我折磨死。	认知歪曲,认知歪曲##心理过滤
因为这些叫做肛裂的东西通常在我排便时撕裂。就像我被自己的狗屎强奸了一样。太疼了，我害怕上厕所。	触发性事件,触发性事件##疾病症状
更有可能的是我有我家人诅咒的椎间盘退行性疾病	认知歪曲,认知歪曲##情绪化推理
我暗自希望我的整个家庭都能以一种不痛苦的方式死去	情绪反应,情绪反应##情感效应
，因为我的病都无法治愈	认知歪曲,认知歪曲##妄下结论
因为我的病都无法治愈	认知歪曲,认知歪曲##否定正面思考
我唯一拥有的技能就是我的学术技能	认知歪曲,认知歪曲##放大和缩小
今天我搞砸了一个重要的考试	触发性事件,触发性事件##学习工作
我生命中的其他一切都是彻底的失败。	认知歪曲,认知歪曲##以偏概全
有关系可言，没有爱好和才能	认知歪曲,认知歪曲##否定正面思考
可能会自杀	情绪反应,情绪反应##情感效应
我想去死	情绪反应,情绪反应##情感效应
我28岁，丈夫29岁，我的婚姻无性	触发性事件,触发性事件##社会关系
也许我长得丑	认知歪曲,认知歪曲##罪责归己/他
我现在在这里，感觉很受伤。	触发性事件,触发性事件##情感
我能解决这个问题的希望已经破灭了	认知歪曲,认知歪曲##妄下结论
但什么都不重要。我的工作不重要。	认知歪曲,认知歪曲##以偏概全
但我只是觉得很空虚	触发性事件,触发性事件##情感
。我只是想结束这一切。	情绪反应,情绪反应##情感效应
我为此恨自己	认知歪曲,认知歪曲##罪责归己/他
我没有目标	认知歪曲,认知歪曲##乱贴标签
我没有激情	认知歪曲,认知歪曲##乱贴标签
我存在，而我的存在往往会给我周围的人带来不便。	认知歪曲,认知歪曲##妄下结论
我希望我没有出生	认知歪曲,认知歪曲##情绪化推理
我的父母因为心脏缺陷失去了他们的第一个孩子，他们的关系摇摇欲坠，我是他们在一起的最后一搏。	触发性事件,触发性事件##社会关系
她现在很少和我说话，只有当她有问题的时候	触发性事件,触发性事件##情感
我爸爸觉得他女朋友更重要，所以在我上大学的前两周把我赶了出去。	触发性事件,触发性事件##生活
我几乎无家可归，现在负债累累。	触发性事件,触发性事件##生活
我遇到了一个人，我们搬到了一起住，但他对我不好，所以我和他分手了。	触发性事件,触发性事件##情感
。今晚他等到我要去上班时才开始吵架。	触发性事件,触发性事件##情感
这是我第一次上班迟到。	触发性事件,触发性事件##学习工作
我很生气我的完美记录被毁了。	认知歪曲,认知歪曲##非此即彼
我不能，因为我住在德克萨斯州，没有空调，白天睡觉(我晚上工作)。	触发性事件,触发性事件##生活,触发性事件,触发性事件##学习工作
我想在工作中结束自己的生命，所以我打电话给我妈妈。	情绪反应,情绪反应##情感效应
我不想那样对她，但我厌倦了一切。	认知歪曲,认知歪曲##妄下结论
我没有得到晋升，因为我在这个岗位上太重要了。	认知歪曲,认知歪曲##放大和缩小
我的压力来自于工作，我的压力来自于开着检查引擎灯亮着的旧车，我的压力来自于我不能做饭的家，因为他的菜已经放了5个月了	认知歪曲,认知歪曲##放大和缩小
试着赚些钱，但还是不够。	驳斥,驳斥##习惯性驳斥
把工作做好，有人比你干得更久。	驳斥,驳斥##习惯性驳斥
公司有一半的时间会让我们失败。	认知歪曲,认知歪曲##放大和缩小
我什么都不喜欢。	驳斥,驳斥##习惯性驳斥
我不喜欢和任何人在一起。	驳斥,驳斥##习惯性驳斥
当男人说爱我的时候，我再也不相信他们了因为这永远不够，或者他们在撒谎。	认知歪曲,认知歪曲##以偏概全
所以我会很穷，很痛苦……我将独自一人……就是这样。	认知歪曲,认知歪曲##妄下结论
为什么我要一直这样生活下去。	认知歪曲,认知歪曲##非此即彼
为什么不能由我来决定我的存在是否值得继续。	驳斥,驳斥##有效驳斥
我不能把自己送进医院，因为那样所有人都会突然对我感兴趣，我就会上当，然后当他们不再关心我时，我就会再次受伤。	认知歪曲,认知歪曲##妄下结论
它会记录在我的医疗记录上，我会错过工作，可能会失去工作，因为我不稳定，我生活在一种随意的状态中。	认知歪曲,认知歪曲##妄下结论
我想结束我的生命，我只是需要发泄，我没有人可以告诉我	认知歪曲,认知歪曲##非此即彼
在经历了充满压力的两年大学生活和因双方吸毒而导致的失败关系后，我搬回了奶奶家	触发性事件,触发性事件##学习工作
我们都非常沮丧，我认为我搬回家是件好事，但每天都感觉更糟。	认知歪曲,认知歪曲##情绪化推理
两周前他又服药过量了，我听说他的情况有所好转，但我决定不联系他，但我太想他了，也许等他感觉好些了，我会尽量少联系他……我过去有过自杀的念头，但自从搬回家后就失去了控制。	情绪反应,情绪反应##情感效应
我的生活没有方向和意义。	认知歪曲,认知歪曲##乱贴标签
我所做的就是打扰大家。	认知歪曲,认知歪曲##罪责归己/他
我的脑子很模糊，无法集中注意力。	触发性事件,触发性事件##疾病症状
在公共场合，感觉每个人要么从我身边跑开，要么盯着我看，我知道这是我的头在和我玩。	认知歪曲,认知歪曲##情绪化推理
我觉得自己像个怪物，而且每个人都能看到。	认知歪曲,认知歪曲##乱贴标签
我有一份体面的工作，每小时工资15美元，但压力太大了。	触发性事件,触发性事件##学习工作
搬回家后，我申请了附近的工作，很快就在一家不错的酒店找到了前台代理的工作，每小时工资10美元。	触发性事件,触发性事件##学习工作
它的节奏确实比较慢，也很酷，但停机时间简直要了我的命。	认知歪曲,认知歪曲##非此即彼
我的思想吞噬了我的生命。	认知歪曲,认知歪曲##放大和缩小
两天前，我和前男友勾搭上了，因为我渴望被抚摸，但显然我感觉糟了十倍。	触发性事件,触发性事件##情感
昨天早上上班的时候，我真的很生气，因为我的子宫颈疼得要命，我没有睡觉，我的情绪完全失控了。	触发性事件,触发性事件##疾病症状
我平时很温柔，但我一整天都觉得自己像个定时炸弹。	认知歪曲,认知歪曲##情绪化推理
我不知道我什么时候会这样做，但我每天下班开车回家的时候都幻想着。	触发性事件,触发性事件##疾病症状
我太懦弱了，不敢开枪自杀或上吊自杀。	认知歪曲,认知歪曲##乱贴标签
我想我已经关闭了word文档，但我有多动症，如果它不附着在我的身体上，我就会失去我的头	触发性事件,触发性事件##疾病症状
所以我昨天一整天都很焦虑，因为我没把文件打开，我的老板在昨晚11点55分打电话给我，他对我大吼大叫，我想知道这是不是原因	认知歪曲,认知歪曲##妄下结论
不然为什么在那个时候打电话给我	认知歪曲,认知歪曲##妄下结论
我只是太害怕了，不敢去上班。	驳斥,驳斥##习惯性驳斥
小学的时候父母吵架，自己在房间用跳绳勒紧了自己的脖子，一头放在床柱上，一头在手里，一拉，世界真的安静下来了，后来喘不上气松手了，我也不知道当时为什么会有这样的想法，时隔多年，它又毫无意识的出现在我的脑海里，“啊，好想去死，真的好想去死”仿佛这是唯一的解脱，却又害怕自杀，等一个意外，我想这仅仅是我对当下一种不满情绪，却找不到任何办法改变，只有拿自己出气吧，毕竟我连蝼蚁都不如。	触发性事件,触发性事件##社会关系,认知歪曲,认知歪曲##乱贴标签,情绪反应,情绪反应##行为效应
说实话，我真的厌倦了一切	认知歪曲,认知歪曲##乱贴标签
我对伤害我的家人感到很难过，但我真的认为从长远来看，他们会过得更好，无论如何，我只是让他们中的大多数人失望。	认知歪曲,认知歪曲##妄下结论
我知道这会伤害她，她会感到困惑和悲伤，但老实说，我无论如何都是一个非常糟糕的榜样。	认知歪曲,认知歪曲##乱贴标签
我从高中辍学了	触发性事件,触发性事件##学习工作
我经常自残，这是一个我一直无法改掉的坏习惯。	触发性事件,触发性事件##疾病症状,情绪反应,情绪反应##行为效应
我的人生无路可走	认知歪曲,认知歪曲##乱贴标签
我想我只是把我所有的药都吃了(我现在吃了两种药，还有两种药是医生开的，但我从来没有吃过)，然后割腕。	情绪反应,情绪反应##行为效应
这条死亡之路是我一手铺垫的，14岁那年自尽未遂后，我并没有感受到重生的喜悦，之后的人生不过是在加速奔向死亡。	认知歪曲,认知歪曲##非此即彼,认知歪曲,认知歪曲##情绪化推理,情绪反应,情绪反应##行为效应
我要自杀了。	情绪反应,情绪反应##行为效应
我自己的家人几乎不跟我说话。	触发性事件,触发性事件##生活
我没有朋友，什么都没有。	驳斥,驳斥##习惯性驳斥
我不能再为自己做任何事了。	驳斥,驳斥##习惯性驳斥
活在这个该死的世界上毫无意义而且没有人会想念我。	驳斥,驳斥##习惯性驳斥
我很少见到他们，也很少和他们说话。	触发性事件,触发性事件##社会关系
我有朋友，但我不认为他们是真正的朋友。	触发性事件,触发性事件##社会关系
我觉得我他妈没有一个人可以谈心。	认知歪曲,认知歪曲##情绪化推理
我是一个变性人，我有暴食症，我受够了	触发性事件,触发性事件##疾病症状
我受够了吃完东西就想自杀。	触发性事件,触发性事件##疾病症状,情绪反应,情绪反应##行为效应
我曾多次试图独自改掉我的习惯，现在我有厌食症患者的心态，但我仍然暴食。	触发性事件,触发性事件##疾病症状
我的愤怒问题已经超出了正常范围，因为睾酮分泌，我再也不能哭了，我因为焦虑、抑郁和自我伤害失去了很多朋友，我今天在塞恩斯伯里超市就恐慌发作了三次，我不想再这样下去了。	触发性事件,触发性事件##疾病症状,触发性事件,触发性事件##社会关系
我总是吃得太多，但在过去的10年里，情况似乎变得更糟了，我在需要安慰的时候吃东西，我吃得太多了，然后感觉很糟糕，所以我吃得更多来应对它。	认知歪曲,认知歪曲##情绪化推理
我知道这是不对的，当我想吃东西的时候，我试着告诉自己咬我的舌头，我需要空腹，我曾经写下我吃的每一卡路里，但我总是崩溃和暴食，又回到了我开始的地方。	认知歪曲,认知歪曲##非此即彼
时间倒回几年前，我陷入了深深的沮丧，失去了工作，朋友、家人都不太理解我，因为我是家里的“害群之马”。	触发性事件,触发性事件##学习工作,认知歪曲,认知歪曲##乱贴标签
我试图割腕自杀，但一个朋友突然出现救了我。	情绪反应,情绪反应##行为效应
我在公共部门工作，保护英国各地学校的学生数据，调查数据泄露等。	触发性事件,触发性事件##学习工作
我没有积蓄，我勉强维持生计，一切似乎都出了问题，崩溃了。	认知歪曲,认知歪曲##非此即彼,认知歪曲,认知歪曲##放大和缩小
我能感觉到自己又陷入了抑郁。	认知歪曲,认知歪曲##情绪化推理
由于被开除的压力和我的事业受到影响，我一直患有头痛，我一直在服用止痛药(可待因)，并且每次都增加剂量来麻痹自己。	触发性事件,触发性事件##疾病症状
我知道这并不像其他人的问题那么可怕，但我一直试图做一个好人，改变世界，但每次我站起来，感觉世界都在踢我。	认知歪曲,认知歪曲##情绪化推理
结束这一切似乎是我现在唯一的想法。	认知歪曲,认知歪曲##非此即彼
从13岁起，我就一直在处理抑郁症和焦虑	触发性事件,触发性事件##疾病症状
现在我他妈就是个白痴	认知歪曲,认知歪曲##乱贴标签
我担心今年也会不及格	触发性事件,触发性事件##学习工作
所有的朋友都很讨厌我，觉得我让他们很尴尬	认知歪曲,认知歪曲##以偏概全
那天晚上我搞砸了和好朋友的友谊	触发性事件,触发性事件##社会关系
我只有在喝醉的时候才会感觉良好	认知歪曲,认知歪曲##心理过滤
就会崩溃和严重焦虑	触发性事件,触发性事件##疾病症状
我的老师讨厌我	触发性事件,触发性事件##社会关系
我这辈子从没做过好事也没做过让人骄傲的事	认知歪曲,认知歪曲##以偏概全
我讨厌、丑陋、懒惰、	认知歪曲,认知歪曲##乱贴标签
我想我快要走到尽头了	情绪反应,情绪反应##情感效应
我是个令人失望的孩子	认知歪曲,认知歪曲##乱贴标签
我差点旧病复发，之前还差点心血来潮就这么自杀了	情绪反应,情绪反应##行为效应
像个小贱人一样	认知歪曲,认知歪曲##乱贴标签
我经历了一场非常痛苦、令人不快的离婚	触发性事件,触发性事件##生活
我的生母在情感上虐待我	触发性事件,触发性事件##情感
当我处于压力环境中时，我时不时地会经历恐慌发作	触发性事件,触发性事件##疾病症状
我不关心我的家庭，我应该出去流浪，自己照顾自己	认知歪曲,认知歪曲##应该句式
觉得我不是一个好人，我不配得到任何东西	认知歪曲,认知歪曲##乱贴标签
但两年的心理学学位让我明白，事实并非如此。	驳斥,驳斥##有效驳斥
我觉得很孤独，被我的朋友和支持网络孤立了	情绪反应,情绪反应##情感效应
我的生活就是垃圾	认知歪曲,认知歪曲##乱贴标签
我女朋友两周前去上大学了，她决定结束我们的关系	触发性事件,触发性事件##情感
昨天我爸爸把我掐死在地上，我去报警了	触发性事件,触发性事件##生活
我母亲也不相信我说的话	触发性事件,触发性事件##生活
每天都有别的事情把我搞砸	认知歪曲,认知歪曲##以偏概全
我已经准备好把自己撞到砖墙上再也不回头了	情绪反应,情绪反应##行为效应
我不想呼吸。我不想说话。	情绪反应,情绪反应##情感效应
我准备结束这一切	情绪反应,情绪反应##行为效应
我脑子里出现一个声音，不停的出现告诉我不能做这个不能做那个，已经一两年的时间了，我打字它告诉我你不能打这个字要打另一个字，不然会有什么后果我爸骂我的事情我就会出现记忆障碍一样记不住	触发性事件,触发性事件##疾病症状
就好害怕	情绪反应,情绪反应##情感效应
又实在活得难过哭的时候喘不动气就会拿尖锐的东西划自己	情绪反应,情绪反应##行为效应
如果被发现了该怎么办看着窗户想跳下去又觉得自己真可怜，阳光这么好我却想跳下去我好难过啊	情绪反应,情绪反应##情感效应
在过去的三个月里，我失业了，辍学了	触发性事件,触发性事件##学习工作
体重增加了20多磅	触发性事件,触发性事件##疾病症状
我也有一段时间没和朋友说过话了	触发性事件,触发性事件##社会关系
我一直对自己的外表感到很尴尬	情绪反应,情绪反应##情感效应
所以我一直躲着所有人，除非迫不得已，否则我不会出去	认知歪曲,认知歪曲##妄下结论
我觉得我已经尝试了所有的方法来停止暴饮暴食，我不再向朋友倾诉，因为我一直无法戒掉暴饮暴食，也无法阻止体重迅速增加	认知歪曲,认知歪曲##以偏概全
这是我两次差点自杀的经历之一另一次是在10年前	情绪反应,情绪反应##行为效应
我只是很害怕我永远不会停止暴饮暴食	情绪反应,情绪反应##情感效应
我看不到出路	认知歪曲,认知歪曲##否定正面思考
我完了，一切都糟透了。我现在一团糟	认知歪曲,认知歪曲##妄下结论
一切出了差错都是我的错	认知歪曲,认知歪曲##罪责归己/他
我不能爱我自己。我不能告诉任何人。我找不到帮助	认知歪曲,认知歪曲##心理过滤
我把一切都搞砸了，已经没有希望补救了	认知歪曲,认知歪曲##罪责归己/他
生活没有意义	认知歪曲,认知歪曲##否定正面思考
我是个错误。我就是个宇宙笑话。我是无性的。我什么都做不好。我不是二元性别。我什么都做不好。我很坏，我知道这是真的	认知歪曲,认知歪曲##乱贴标签
我配不上你的能量，因为我是个黑洞	认知歪曲,认知歪曲##乱贴标签
大学一年级不及格	触发性事件,触发性事件##学习工作
现在我负债累累。我没有工作	触发性事件,触发性事件##学习工作
因为我也害怕失败	情绪反应,情绪反应##情感效应
我就活不下去了	认知歪曲,认知歪曲##妄下结论
我失败了。这是结束了	认知歪曲,认知歪曲##妄下结论
我是一个斑点，在一个污点上，在一个粒子上，在一粒沙子上，在一个海滩上，在数十亿的海滩中，所以任何事情都无所谓	认知歪曲,认知歪曲##乱贴标签
为什么我的生活一直是一个恶心的宇宙笑话	认知歪曲,认知歪曲##乱贴标签
生活是痛苦的	认知歪曲,认知歪曲##妄下结论
我要自杀了	情绪反应,情绪反应##行为效应
抑郁症似乎就一直是我生活的一部分	触发性事件,触发性事件##疾病症状
我的母亲死于乳腺癌	触发性事件,触发性事件##社会关系
我就再也不一样了	认知歪曲,认知歪曲##妄下结论
我的沮丧和悲伤主要来自悲伤	情绪反应,情绪反应##情感效应
我开始责怪自己	认知歪曲,认知歪曲##罪责归己/他
并不一定是因为我母亲的死，而是因为所有出了问题的事情	驳斥,驳斥##有效驳斥
我第一次有自杀的念头是在我11岁的时候，从那以后，这种念头就一直来来去去	情绪反应,情绪反应##情感效应
我最终也开始责怪自己是同性恋	认知歪曲,认知歪曲##罪责归己/他
我开始称自己为"该死的基佬"等等	认知歪曲,认知歪曲##乱贴标签
每当我做错事的时候，我都会说自己的坏话	驳斥,驳斥##习惯性驳斥
他们可以从“你是个可怕的人”到“没有人爱或关心你”	认知歪曲,认知歪曲##乱贴标签
那些我有朋友的人似乎从来不会和我说话，除非我先去找他们	认知歪曲,认知歪曲##以偏概全
当然他们从来没有担心过	认知歪曲,认知歪曲##以偏概全
但我今天真的感觉不太好	情绪反应,情绪反应##情感效应
但今天我三次想到自杀	情绪反应,情绪反应##情感效应
我被我最亲近的人背叛了	触发性事件,触发性事件##社会关系
我一直在努力找工作，感觉被困住了	触发性事件,触发性事件##学习工作
我觉得我总是以最低的频率吸引最糟糕的人	认知歪曲,认知歪曲##妄下结论
我有很多父母的问题	触发性事件,触发性事件##社会关系
这是我明天早上第七次企图自杀	情绪反应,情绪反应##行为效应
人们倾向于喜欢我，但我把自己孤立起来。很多人关心我，但我从不参加任何社交活动，因为我觉得和任何人一起做任何事都很不自在。	认知歪曲,认知歪曲##妄下结论
知道我给家人和其他人带来了多大的压力，知道我的死会给家人和其他人带来多大的痛苦，我很伤心	认知歪曲,认知歪曲##罪责归己/他
我有越来越严重的抑郁和焦虑	触发性事件,触发性事件##疾病症状
但我可能会继续尝试自杀	情绪反应,情绪反应##行为效应
我感到很内疚。但我太累了	情绪反应,情绪反应##情感效应
我有精神疾病。我患有抑郁症、焦虑症，还被诊断出患有创伤后应激障碍	触发性事件,触发性事件##疾病症状
导致我自杀的原因是总体上的懒惰	认知歪曲,认知歪曲##乱贴标签
我看到并感受到我每天遭受的痛苦	情绪反应,情绪反应##情感效应
我没有任何支持我的人	认知歪曲,认知歪曲##以偏概全
我试着去公共场合，却发现人们不想靠近我。他们看我就像看动物一样	触发性事件,触发性事件##社会关系
有些人说他们可能关心我，而我的感觉却恰恰相反，他们或多或少地怨恨我	认知歪曲,认知歪曲##妄下结论
但除了工作人员的虐待之外	触发性事件,触发性事件##社会关系
我只是情绪上的不安	情绪反应,情绪反应##情感效应
我的脑海中只有自杀的想法。我过去的创伤历史和现在的生活让我感到沮丧	情绪反应,情绪反应##情感效应
因为我觉得自己毫无价值，毫无用处	认知歪曲,认知歪曲##乱贴标签
我对自己生气、伤心、哭泣	情绪反应,情绪反应##情感效应
我经常有自我伤害的冲动，使用武器和杠杆把自己置于完全危险的境地	情绪反应,情绪反应##行为效应
我倾向于对自己和他人采取暴力行为，如果有人在身边，我知道我有能力伤害甚至可能杀死别人。	认知歪曲,认知歪曲##情绪化推理
我无法独自应对，直到今天，我仍然感到孤独，即使有人可能正在经历他们自己的痛苦，但作为社会的受害者，作为我自己的受害者，我看不到这一点，因为我被自己的问题困住了，被我的思想囚禁了。	认知歪曲,认知歪曲##心理过滤
我没有支持，我没有家人，也没有朋友	认知歪曲,认知歪曲##以偏概全
甚至像对待社会的毒瘤一样对待我	认知歪曲,认知歪曲##乱贴标签
此时此刻我感到焦虑	情绪反应,情绪反应##情感效应
每当我像我这样焦虑的时候，我的焦虑就会飙升，我的腿就会像冲击波一样，我的下巴有时会紧闭，我的手臂开始颤抖，或者有时如果情况真的很严重，我就会呕吐，咳出肺部的血	触发性事件,触发性事件##疾病症状
这很可能是我经历过的创伤事件的闪回，我辗转反侧，独自醒来，冒着冷汗，有时尖叫，呼吸沉重。	触发性事件,触发性事件##疾病症状
我在2017年尝试过自杀	情绪反应,情绪反应##行为效应
抑郁症的原因(我实际上从未被诊断出来，但有所有的症状)是虐待	触发性事件,触发性事件##疾病症状
我从幼儿园开始(大约5岁)就被大声喊叫和殴打，从小学开始就因为我的长相(超重)而被羞辱和欺负	触发性事件,触发性事件##社会关系
为了达到我的高期望(全优)，压力越来越大	触发性事件,触发性事件##学习工作
自从我康复后，我一直在努力变瘦，但我的父母说我不能节食，因为我太年轻了(而不是节食，我刚开始吃得更健康)，我爸爸不再打我了，因为他知道我越来越强壮(锻炼)，会反击	驳斥,驳斥##有效驳斥
但情绪控制和言语虐待并没有停止。	触发性事件,触发性事件##社会关系
在我回来的第二天，我爸爸突然冒出来想亲我，但是我的胳膊挡住了我的路。他立刻开始对我大喊大叫，说我不尊重他，说我不知道什么是爱，说我不爱他，说我对他为我所做的一切是多么忘恩负义。他还高喊要剥夺我的所有权利，包括言论自由。每当我想说什么时，他都会打断我，大喊“不要回答我!”他说他讨厌他冲我吼的时候我放松的样子。	触发性事件,触发性事件##社会关系
我精神崩溃了	情绪反应,情绪反应##情感效应
那天晚上他说对了一件事，那就是我不爱他，我两年前就意识到我不爱他。	驳斥,驳斥##习惯性驳斥
如果不是因为这个国家的法律，我会杀了他，但我甚至无法为自己辩护，因为我情绪太激动了，我说不出什么，我只是想象着杀了他。	认知歪曲,认知歪曲##情绪化推理
我觉得未来毫无意义	认知歪曲,认知歪曲##否定正面思考
在中学的时候，我每年都是优等生，我父母经常吵架，不过没什么结果，直到我妈妈觉得她受够了，把我和我妹妹留给了我父亲，她每天都对我们大喊大叫，诅咒我们出生的那一天，说我们的母亲是一个糟糕的女人，那段时间我们没有和我母亲联系。	触发性事件,触发性事件##社会关系
我得了抑郁症	触发性事件,触发性事件##疾病症状
成绩开始下降，成绩很差	触发性事件,触发性事件##学习工作
我觉得这毫无意义	认知歪曲,认知歪曲##否定正面思考
我的父母不爱我，我的父亲讨厌我，我觉得他有躁郁症，我的母亲会无视我们，除非我们和她住在一起	触发性事件,触发性事件##社会关系,认知歪曲,认知歪曲##妄下结论
几次试图自杀	情绪反应,情绪反应##行为效应
我患双相情感障碍已经有十年了。早些时候，我断断续续地服用药物。我已经用了几年了，现在做了一些调整。在这期间，我被诊断出患有不治之症	触发性事件,触发性事件##疾病症状
我失去了我的奶奶，我失去了我的爷爷，我和我的母亲没有任何关系	触发性事件,触发性事件##社会关系
工作上的问题(骚扰)、对生存的焦虑和其他事情	触发性事件,触发性事件##学习工作
我爱他。他让我开心，他会倾听，他会支持我，他是我想和他在一起的人。他决定不干了。没有理由。他趁我上班的时候把他的东西都带走了。	触发性事件,触发性事件##情感
我有一种不想再活下去的感觉	情绪反应,情绪反应##情感效应
我在拔头发，剪头发，抽烟，喝酒，谁知道我还会做什么。	情绪反应,情绪反应##行为效应
但事实是我累了	情绪反应,情绪反应##情感效应
我觉得我不能再这样下去了	驳斥,驳斥##习惯性驳斥
这是愚蠢的	认知歪曲,认知歪曲##乱贴标签
我甚至没有什么可沮丧的	认知歪曲,认知歪曲##妄下结论
但我恨我自己	认知歪曲,认知歪曲##罪责归己/他
我觉得自己像坨屎。一种负担	认知歪曲,认知歪曲##乱贴标签
我不能再这样下去了。	驳斥,驳斥##习惯性驳斥
我首先要说的是，请不要怜悯我。我不是在寻求关注。	驳斥,驳斥##习惯性驳斥
我有严重的焦虑症，临床抑郁症，还有令人心碎的广场恐惧症	触发性事件,触发性事件##疾病症状
我高中就辍学了，连普通教育文凭都没有	触发性事件,触发性事件##学习工作
我觉得自己是个失败者，是家人的负担	认知歪曲,认知歪曲##乱贴标签
现在我的余生都在服用血液稀释剂，不管这将持续多久	触发性事件,触发性事件##疾病症状
我觉得我把太多的责任放在了我的家庭身上，而不是必要的，我为自己不能简单地正常而感到羞愧。	认知歪曲,认知歪曲##罪责归己/他
我太害怕做一些会给我带来痛苦的事情，所以这就是我选择过量用药的原因。	情绪反应,情绪反应##情感效应
我想在睡梦中死去，因为这是一种平静的方式。	认知歪曲,认知歪曲##情绪化推理
我昨晚第二次差点自杀了	情绪反应,情绪反应##行为效应
我觉得很孤单	情绪反应,情绪反应##情感效应
我从中学开始就患有抑郁症(我现在21岁了)	触发性事件,触发性事件##疾病症状
像往常一样。我和男朋友又吵了一架，因为我永远不能向他吐露我的感受。	触发性事件,触发性事件##情感
我总是想自杀	情绪反应,情绪反应##情感效应
在去旧金山的路上，我意识到我的方法很荒谬，因为我非常恐高。而且我现在不能自杀，因为我要照顾这些狗，而它们的主人几周后就要出国几个月了。如果我死了，他们就没人遛哈巴狗了。	驳斥,驳斥##有效驳斥
我在大学里从未真正交过新朋友。我不和高中的老朋友说话	触发性事件,触发性事件##社会关系
我感到非常非常孤独	情绪反应,情绪反应##情感效应
我真的很想死，但我最后一次尝试是在10月	情绪反应,情绪反应##行为效应
我真的很想死，活着感觉太不对了	情绪反应,情绪反应##情感效应
而且我敢肯定，无论我多么努力，我都不会对我的生活感到满意	认知歪曲,认知歪曲##妄下结论,认知歪曲,认知歪曲##情绪化推理
我在服药，我去接受治疗	触发性事件,触发性事件##疾病症状
我觉得我是世界上最愚蠢、最没用的人	认知歪曲,认知歪曲##乱贴标签
我不配活下去，我也不想活下去	认知歪曲,认知歪曲##妄下结论
我恶心，忘恩负义，是世上最坏的人	认知歪曲,认知歪曲##乱贴标签
我试图制定一个计划，让我的自杀看起来像是一场意外	情绪反应,情绪反应##行为效应
我不想让我的父母和妹妹再经历一次那样的经历。还有，我很想自残，但我答应过我妈妈我不会再这样做了	驳斥,驳斥##习惯性驳斥
我很想自残	情绪反应,情绪反应##情感效应
我申请了研究生院，但没有被录取	触发性事件,触发性事件##学习工作
我在零售业工作，每周10-20小时。我每周也在一个研究实验室工作5个小时。我很容易累。我觉得自己很没用，因为我不能工作，而且今年8月也不能上学。	触发性事件,触发性事件##学习工作
自二月份以来，我一直患有偏执狂和幻听，我确信我的教授们是来抓我的……我被监视了，等等	触发性事件,触发性事件##疾病症状
我患有童年受虐造成的创伤后应激障碍症状。而且基本上和一个让我想起童年被虐待的人住在一起。	触发性事件,触发性事件##疾病症状
但当我经常有自杀的想法时，就走不远了	情绪反应,情绪反应##情感效应
我一直在研究自杀的方法。我最近发现了一个，并真的喜欢上了。我在计划准备好所有工具后独自在家的第一天	情绪反应,情绪反应##行为效应
不想再活下去了	情绪反应,情绪反应##情感效应
我都不记得上次开心是什么时候了。每天感觉都一样。	认知歪曲,认知歪曲##心理过滤
我厌倦了工作。厌倦了大学生活。	触发性事件,触发性事件##学习工作
厌倦了一辈子住在同一个破地方。我身无分文。	触发性事件,触发性事件##生活
没有人可以说话。不知道怎么跟人说话了。	触发性事件,触发性事件##社会关系
我总是想自杀	情绪反应,情绪反应##情感效应
我只是想感受一些除了愤怒、悲伤和孤独之外的东西	情绪反应,情绪反应##情感效应
对我来说，一切都是笑话。毫无意义的。	认知歪曲,认知歪曲##妄下结论
因为焦虑，我的记忆力变差了。我换过很多次药。没有什么工作。	触发性事件,触发性事件##疾病症状
我已经尽了最大的努力来改变我的生活，但还没有任何结果。我想结束。	认知歪曲,认知歪曲##情绪化推理
我一生中从未如此沮丧过....以前从来没有这么糟糕过	认知歪曲,认知歪曲##以偏概全
我厌倦了每天哭泣和永远的焦虑发作....	触发性事件,触发性事件##疾病症状
原来他们决定取消原来给我提供的职位，所以我没有工作	触发性事件,触发性事件##学习工作
我以前找工作从来没有遇到过困难，但这次太糟糕了。我参加了50多次面试，没有一次成功，除了一次招聘经理给我的机会，但后来被公司老板拒绝了，因为我本来是招聘经理之外唯一的女性，而他只希望男性在那里工作(我正在向他们提出投诉)。	触发性事件,触发性事件##学习工作
我已经两个月没钱了，因为我把钱都给我男朋友用了，因为我没想到我会有这么多麻烦。我们的关系日益恶化，因为现在我们俩都没钱了，他把一切都怪我，因为我没钱了。	触发性事件,触发性事件##情感
我意识到我要打两到三份工才能给我们买一套公寓，但我仍然找不到工作。没有钱。	触发性事件,触发性事件##学习工作
我的朋友们(其中一些和我住在一起)都受够了我一直向他们要钱。	触发性事件,触发性事件##社会关系
我失去了一切，一切都没有好转....	认知歪曲,认知歪曲##以偏概全
我只是不想再活下去了	情绪反应,情绪反应##情感效应
每当我感到沮丧时，我就会考虑自杀的想法，但我从来没有这样做过	情绪反应,情绪反应##情感效应
因为在我内心深处，我知道是我的抑郁在思考，而不是我的大脑	驳斥,驳斥##有效驳斥
我第一次用批判的思维分析一切。生活就是他妈的没有意义。这个世界的运作方式，是任何人能想到的最愚蠢的系统	认知歪曲,认知歪曲##情绪化推理
生活就是他妈的没有意义	认知歪曲,认知歪曲##否定正面思考
我现在在这里很沮丧，很绝望	情绪反应,情绪反应##情感效应
因为我找不到工作	触发性事件,触发性事件##学习工作
自从三年前毕业后我就一直在找工作，但在这里，如果你没有经验，你长得丑，或者他们根本不了解你，就没有人雇你	触发性事件,触发性事件##学习工作
我不能说话。从我记事起，这就是我一生中最大的问题。我不知道怎么跟人说话。我不能表达自己，我甚至不能一个人去杂货店买东西	触发性事件,触发性事件##社会关系
我过去有过社交焦虑症	触发性事件,触发性事件##疾病症状
我所有的问题都源于我缺乏社交技巧	认知歪曲,认知歪曲##罪责归己/他
我一直都怪我的家人把我养得像坨屎让我成长为一个自私的不会说话的混蛋	认知歪曲,认知歪曲##乱贴标签
我总是讨厌所有不喜欢我的人	认知歪曲,认知歪曲##以偏概全
但最后我意识到我只能怪我自己，我过着这种糟糕的生活。我他妈的恨我自己	认知歪曲,认知歪曲##罪责归己/他
我他妈讨厌自己孤立自己，把所有人都推开	认知歪曲,认知歪曲##罪责归己/他
我本可以有很多朋友，但我把他们推开了	认知歪曲,认知歪曲##情绪化推理
我从来没有为任何人做过好事	认知歪曲,认知歪曲##以偏概全
我他妈想不出我为谁做过一件微不足道的好事	认知歪曲,认知歪曲##以偏概全
因为我觉得这个世界的其他地方不值得我去做	认知歪曲,认知歪曲##妄下结论
现在我明白了，我总是责怪我的成长，天啊，我是唯一一个应该受到责备的人，我太痛苦了。	认知歪曲,认知歪曲##罪责归己/他
我很讨厌我自己。	认知歪曲,认知歪曲##罪责归己/他
现在我想改变这一点，但我不能，因为我从来没有给过这样做的工具	认知歪曲,认知歪曲##情绪化推理
我姐姐是我生命中唯一的支柱，但昨天她决定停止帮助我，因为我从来没有做过任何与她给我的帮助	触发性事件,触发性事件##社会关系
我讨厌看到她浪费生命去帮助像我这样的失败者	认知歪曲,认知歪曲##乱贴标签
我以前看过心理医生，过去几年我看了四个不同的医生，但是他们从来没有帮助过我	认知歪曲,认知歪曲##妄下结论
我没有工作	触发性事件,触发性事件##学习工作
而我也没办法找到工作	认知歪曲,认知歪曲##妄下结论
想知道像我这样的一个活着的狗屎是怎么熬到月底的	认知歪曲,认知歪曲##乱贴标签
我他妈的绝望了	情绪反应,情绪反应##情感效应
我甚至不想死。有很多事情我想做，但我不能，因为我的方式。我不想死	驳斥,驳斥##习惯性驳斥
我只是不想再做我自己了我他妈讨厌现在的我。我无法“变回”自己。我不知道怎么回事，我甚至不认为这是可能的。我讨厌活在自己的皮肤里。	认知歪曲,认知歪曲##情绪化推理
我知道他们帮不了我。现在唯一能帮我的人就是我自己。但是我做不到。我给自己下了10天的最后通牒，让自己想清楚。如果我找不到解决这个问题的办法，我就要自杀了。	认知歪曲,认知歪曲##情绪化推理
我一直想成为一名编剧，但我放弃了这个想法，因为我的写作很糟糕	认知歪曲,认知歪曲##否定正面思考
学业上的压力和没有目的的生活让我跳了起来	触发性事件,触发性事件##学习工作
我会从我家附近的四层楼跳下去	情绪反应,情绪反应##情感效应
我打算过量服用瘦肉精或其他药物	情绪反应,情绪反应##情感效应
我知道我的父母只会说抑郁和自杀的想法很常见，他们会关注我的成绩和GPA。	触发性事件,触发性事件##社会关系
我感到绝望	情绪反应,情绪反应##情感效应
我觉得我离开总比工作、学习、准备学校和SAT要好	触发性事件,触发性事件##学习工作,认知歪曲,认知歪曲##情绪化推理
对我来说，这就是生活的全部	认知歪曲,认知歪曲##妄下结论
每次你骂我，说如果我SAT考不好，就把我送到学院，我的狗就被强迫吃罐头食品，我的心都碎了	触发性事件,触发性事件##社会关系
我SAT考不好	触发性事件,触发性事件##学习工作
如果是这样，那我最好还是跳下去消失，这样你就可以照顾我的狗了	认知歪曲,认知歪曲##情绪化推理
自杀这个问题自从我十几岁上初中聋了以后一直想到现在	情绪反应,情绪反应##情感效应
失去听力意味着总是被误解	触发性事件,触发性事件##疾病症状
没有朋友	触发性事件,触发性事件##社会关系
因为每次想死都会觉得我的血液内脏眼角膜什么的就这样报废实在是太浪费了.......毕竟多少人在医院里想要还买不到	驳斥,驳斥##有效驳斥
我有一个自杀的计划	情绪反应,情绪反应##行为效应
我一直在与双相情感障碍作斗争	触发性事件,触发性事件##疾病症状
如果我不喝醉或不嗨，我就不开心，即使那样我也不享受生活	认知歪曲,认知歪曲##情绪化推理
但我已经厌倦了生活	认知歪曲,认知歪曲##妄下结论
我在这个世界上从来没有安全感，我从来不能相信任何人	认知歪曲,认知歪曲##妄下结论
我爸爸从来都不理解精神疾病	触发性事件,触发性事件##社会关系
但我觉得“克服”它的唯一方法就是去死	认知歪曲,认知歪曲##妄下结论
问题是我的内心已经崩溃了。甚至很难描述我内心的真实情况。最近我有几次想过自杀	情绪反应,情绪反应##情感效应
我在社交场合变得焦虑和偏执	触发性事件,触发性事件##疾病症状
我对任何人都没有强烈的情感联系，花更多的时间在我的脑海中创造我的生活和我周围的人的理想化版本，而不是在现实生活中	情绪反应,情绪反应##情感效应
我觉得好像没有人可以倾诉，因为没有一个了解我的人会相信我	认知歪曲,认知歪曲##以偏概全
我试着和班上的人说话，但是他们只看到了我的外表	认知歪曲,认知歪曲##妄下结论
我害怕失败，有时甚至害怕自己的想法	情绪反应,情绪反应##情感效应
我是个控制欲很强的骗子	认知歪曲,认知歪曲##乱贴标签
为了让自己看起来漂亮，我愿意做任何事	认知歪曲,认知歪曲##放大和缩小
我对未来的看法也很沮丧，因为我认为没有必要努力学习	认知歪曲,认知歪曲##否定正面思考
如果我的生活是一个老人，没有任何用处	认知歪曲,认知歪曲##乱贴标签
但我知道我永远无法实现我的理想	认知歪曲,认知歪曲##否定正面思考
也许这样我就不会有自杀的念头了	情绪反应,情绪反应##情感效应
我为了向我认识的人倾诉而破坏了人际关系	触发性事件,触发性事件##社会关系
9月份我试图结束自己的生命	情绪反应,情绪反应##行为效应
我有躁郁症的症状	触发性事件,触发性事件##疾病症状
大多数情况下，我只是想发泄一下没有工作是如何的，并给自己一些时间来反思，我已经接受了这里的关键事情。	驳斥,驳斥##习惯性驳斥
我从来没有激情，没有目标，没有梦想，甚至没有一个愚蠢的爱好	认知歪曲,认知歪曲##否定正面思考
我从未上过学，因为我的父母拒绝共同签署贷款，我和朋友们的关系也毫无意义	触发性事件,触发性事件##社会关系
我一直在没有教育背景的情况下工作，接受一个又一个我绝对讨厌的死胡同工作	触发性事件,触发性事件##学习工作
但我从来没有赚到足够的钱来养活自己	认知歪曲,认知歪曲##以偏概全
我的男朋友要回学校了，想要有所作为，而我的感觉就是嫉妒和害怕他会被更好的人抢走	认知歪曲,认知歪曲##情绪化推理
我真的是一个可悲的失败者	认知歪曲,认知歪曲##乱贴标签
我是个废物	认知歪曲,认知歪曲##乱贴标签
我认识的每个人都对我感到沮丧	认知歪曲,认知歪曲##以偏概全
但是我再也不能振作起来了，我就是没有精力了	认知歪曲,认知歪曲##否定正面思考
当我绝望地大声呼救却无人倾听时，我感到很孤独	情绪反应,情绪反应##情感效应
我每周都去看心理医生，但毫无作用	认知歪曲,认知歪曲##妄下结论
她看着我就像看着一只可怜的小狗	认知歪曲,认知歪曲##乱贴标签
我简直是最大的失败者	认知歪曲,认知歪曲##乱贴标签
我的成绩本来很好，但现在降到了平均C。我甚至挂了一门课	触发性事件,触发性事件##学习工作
但我的朋友基本上只是利用我	触发性事件,触发性事件##社会关系
我活下去的意愿一直很低	认知歪曲,认知歪曲##妄下结论
我的生活不是狗屎，但我觉得它不再值得了	驳斥,驳斥##习惯性驳斥
家人不理解	触发性事件,触发性事件##社会关系
每天压抑	情绪反应,情绪反应##情感效应
让我按照他们的想法过完这一生对我来说是生不如死	认知歪曲,认知歪曲##放大和缩小
隐性抑郁好多年了	触发性事件,触发性事件##疾病症状
有些人表面看着没什么不正常，可是里子却烂透了，死是一种解脱	认知歪曲,认知歪曲##妄下结论
我一直在与严重的抑郁症作斗争。	触发性事件,触发性事件##疾病症状
然后COVID发生了，我的实习被取消了	触发性事件,触发性事件##学习工作
失去我的经济援助	触发性事件,触发性事件##生活
严重的焦虑和恐慌发作	触发性事件,触发性事件##疾病症状
我唯一的一个好朋友直接背弃了我，不再和我说话。	触发性事件,触发性事件##社会关系
现在有严重的牙齿问题	触发性事件,触发性事件##疾病症状
我也没有医疗保险	触发性事件,触发性事件##生活
我有阿斯伯格综合症。	触发性事件,触发性事件##疾病症状
真的没有什么朋友	触发性事件,触发性事件##社会关系
我感觉被困住了，没有出路。	认知歪曲,认知歪曲##妄下结论
我没有力气了，我不想再战斗了。	认知歪曲,认知歪曲##放大和缩小
这是永恒的，永远不会结束	认知歪曲,认知歪曲##妄下结论
患有抑郁症人格障碍，而且不太可能对药物起作用(我已经尝试了很多药物)	触发性事件,触发性事件##疾病症状
我失去了我爱的女人	触发性事件,触发性事件##情感
因为在一起7年后我无法做出承诺，主要是因为我觉得当我知道我只会自杀的时候，我觉得没有任何意义。	认知歪曲,认知歪曲##妄下结论
几乎没有人真正理解我在说什么	触发性事件,触发性事件##情感
我觉得他是个好人，我很高兴她和一个能照顾她的人在一起，因为很明显，从长远来看，我永远无法做到这一点。	认知歪曲,认知歪曲##妄下结论
我觉得对我来说，每条路都通向自杀。	认知歪曲,认知歪曲##妄下结论
拿到了一个毫无用处的学位	认知歪曲,认知歪曲##妄下结论
拿到了一个毫无用处的学位，却因此欠下了如山的债务	触发性事件,触发性事件##生活
我意识到我的任何兴趣都不会给我带来薪水，因为它们在商业世界里毫无用处。	认知歪曲,认知歪曲##情绪化推理
被解雇过一次，而且没有事先通知就辞了另外两份工作。	触发性事件,触发性事件##学习工作
我很容易沉迷于书籍和电子游戏来逃避现实。	驳斥,驳斥##习惯性驳斥
患有自闭症	触发性事件,触发性事件##疾病症状
但在我看过的任何地方，他们都不存在。	触发性事件,触发性事件##社会关系
。我是个混蛋，我应该自杀。	认知歪曲,认知歪曲##乱贴标签
我是个混蛋，我应该自杀	认知歪曲,认知歪曲##罪责归己/他
我应该自杀。	认知歪曲,认知歪曲##应该句式
我觉得这是一定会发生的事情，因为我不能再忍受5年的生活，更不用说50年了。	认知歪曲,认知歪曲##情绪化推理
因经济问题而辍学	触发性事件,触发性事件##学习工作
所以我赚不到足够的钱买食物，肥皂，牙膏等必需品	触发性事件,触发性事件##生活
我试图找到另一份工作，但我找不到。	触发性事件,触发性事件##学习工作
我觉得我会永远被困在这个洞里，我的一部分只是希望一切都结束。	认知歪曲,认知歪曲##妄下结论
已经 3 个月没能负担得起理发了	触发性事件,触发性事件##生活
因为我的头发从不长，感觉很恶心。	认知歪曲,认知歪曲##情绪化推理
不能停止自杀的想法。	情绪反应,情绪反应##情感效应
因为我一直有自杀的念头。	情绪反应,情绪反应##情感效应
我的新工作过得很糟糕。	触发性事件,触发性事件##学习工作
我为逃避作为员工的责任而感到内疚，但如果我现在就在那里，我会感觉更糟。	认知歪曲,认知歪曲##应该句式
这份工作影响了我和女朋友的关系。	触发性事件,触发性事件##情感
一切都很烦人。	认知歪曲,认知歪曲##以偏概全
我太讨厌这份工作了，我想过如果我做了，我的女朋友会离开我	认知歪曲,认知歪曲##妄下结论
我想要的是专注于学习，这样我就能找到一份我真正喜欢的工作	认知歪曲,认知歪曲##妄下结论
我也害怕放弃，因为我知道这是“生活的方式”，因为我是一个成年人，我被期望去工作	认知歪曲,认知歪曲##应该句式
如果我继续做这份工作，我就不能集中精力学习，永远也摆脱不了这个怪圈。	认知歪曲,认知歪曲##妄下结论
和我住在一起的父母明确表示，他们对我花了他们这么多钱感到不满，他们也以同样的方式谈到了他们离婚时的压力。他们甚至指责我故意被精神病院拘留，以损害他们的财务状况。	触发性事件,触发性事件##社会关系
继续告诉我我有多没用，我会失去工作，每个人都会恨我。	触发性事件,触发性事件##社会关系
如果我18岁以后还留在这里，我就得把我所有的钱都给他，这些钱我需要吃饭、穿衣服，希望还能上大学。	触发性事件,触发性事件##生活
我唯一能想到的就是结束这一切。	情绪反应,情绪反应##情感效应
我很久没有这种感觉了，但我不认为在这些情况下我会感觉更好。	认知歪曲,认知歪曲##情绪化推理
双相的长期情绪极端化，	触发性事件,触发性事件##疾病症状
这是我的生活，我一点都不坚强，所以我承担不了我的现状我的糟糕，所以我想要自杀	认知歪曲,认知歪曲##情绪化推理
这是我的生活，我一点都不坚强，所以我承担不了我的现状我的糟糕，所以我想要自杀。	认知歪曲,认知歪曲##乱贴标签
我一点都不坚强	认知歪曲,认知歪曲##罪责归己/他
所以我想要自杀	情绪反应,情绪反应##情感效应
但即使这是一件好事，我也不高兴。	认知歪曲,认知歪曲##否定正面思考
我在社会上的挣扎让我很沮丧	情绪反应,情绪反应##情感效应
我患有自闭症谱系障碍。更像是阿斯伯格综合症	触发性事件,触发性事件##疾病症状
人们已经忽略了我。没注意听我说的话。我在现实生活中从来没有朋友。	触发性事件,触发性事件##社会关系
我是个比较冷漠的人	认知歪曲,认知歪曲##乱贴标签
我是个比较冷漠的人。	认知歪曲,认知歪曲##罪责归己/他
我班上的男生只会因为我的课堂笔记而跟我说话。	认知歪曲,认知歪曲##以偏概全
我希望我从一开始就不存在。我的生活再也没有意义了。	认知歪曲,认知歪曲##妄下结论
自从隔离后我都没法专心上课了。	触发性事件,触发性事件##学习工作
但在某种程度上，这对我来说似乎是一个不可能实现的目标。	认知歪曲,认知歪曲##情绪化推理
我最近感觉很虚弱	情绪反应,情绪反应##情感效应
自杀一直是我的选择	情绪反应,情绪反应##情感效应
死亡的想法安慰我，我不会再痛苦了	情绪反应,情绪反应##情感效应
我不想再存在了。我觉得自己是别人的负担。	认知歪曲,认知歪曲##罪责归己/他
我什么都失败了，什么都失败了，我不知道时间去了哪里，	认知歪曲,认知歪曲##情绪化推理
没有工作没有朋友，没有高中毕业，我甚至不知道如何开车，	触发性事件,触发性事件##社会关系
没有高中毕业，	触发性事件,触发性事件##学习工作
抑郁	触发性事件,触发性事件##疾病症状
了焦虑和偏执	触发性事件,触发性事件##疾病症状
焦虑和偏执。	情绪反应,情绪反应##情感效应
我唯一的选择就是找一份最低工资的工作，	认知歪曲,认知歪曲##情绪化推理
我不知道我的情况有多糟糕，但它已经变得更糟了	认知歪曲,认知歪曲##妄下结论
有可能这么多年的隔离生活让我的大脑受到了损伤。	认知歪曲,认知歪曲##妄下结论
我没有这方面的天赋。	认知歪曲,认知歪曲##情绪化推理
我真的做不到什么有用的东西，生活变成了地狱。	认知歪曲,认知歪曲##妄下结论
对我来说自杀是唯一的选择，	情绪反应,情绪反应##情感效应
对我来说自杀是唯一的选择，我讨厌这如此多的我不想死，我不想我的生活是这样的，链接在我的脑海里，我真的无法挽救自己，我必须死。	认知歪曲,认知歪曲##情绪化推理
没有朋友	触发性事件,触发性事件##社会关系
今年秋天开始上大学，压力真的很大	触发性事件,触发性事件##学习工作
我想我对这件事期望太高了。	认知歪曲,认知歪曲##罪责归己/他
我觉得一切都到此为止了。	认知歪曲,认知歪曲##妄下结论
我觉得我的生命不值得活下去。	认知歪曲,认知歪曲##妄下结论
我总是沉浸在美好的幻想中。它让我做出错误的决定追逐奇怪的幻想。	认知歪曲,认知歪曲##以偏概全
我想要一辆好车和一所好房子，但这解决不了任何问题	认知歪曲,认知歪曲##妄下结论
我认为我需要的是让自己变得更好，这样我才能拥有健康而有意义的人际关系和收入来源	认知歪曲,认知歪曲##应该句式
我真的只想结束这段感情。	情绪反应,情绪反应##情感效应
我想我从很小的时候就开始遭受抑郁症的折磨，我说的是13岁或更大的时候。	触发性事件,触发性事件##疾病症状
我只剩下一个朋友	触发性事件,触发性事件##社会关系
我觉得我们的友谊是建立在我一直在经济上帮助他的基础上的，如果不是这样的话，我们也不会再是朋友了。	认知歪曲,认知歪曲##否定正面思考
在女人身上从来没有运气，有一次我和一个女孩约会，在我们一起出去玩了一天之后，她就不再和我说话了。	认知歪曲,认知歪曲##以偏概全
我的父亲在我很小的时候就去世了，我没有得到任何指导	触发性事件,触发性事件##社会关系
我没有兄弟。我在一个女性家庭长大，我是独生子。我有一只宠物猫，它是我生命中唯一的乐趣，然后它也死了。	触发性事件,触发性事件##社会关系
空虚，沮丧，空虚，悲伤，孤独	情绪反应,情绪反应##情感效应
，这个世界是一个病态的地方	认知歪曲,认知歪曲##乱贴标签
我也患有幽闭恐惧症	触发性事件,触发性事件##疾病症状
然而我有一个巨大的渴望死亡	情绪反应,情绪反应##情感效应
我和一个骑自行车的人发生了车祸。	触发性事件,触发性事件##生活
该行为将被判至少2年监禁，并长期禁止驾驶。	触发性事件,触发性事件##生活
我失去了我从网站设计等方面投入到公司的所有钱，这几乎是我的一切。	触发性事件,触发性事件##生活
我女朋友要离开我了，因为我要进监狱2年多。	触发性事件,触发性事件##情感
显然我是个糟糕的男友她想为了一个性侵她的人离开我。	认知歪曲,认知歪曲##妄下结论
糟糕的男友	认知歪曲,认知歪曲##乱贴标签
整个情况的压力给我爸爸本来就很虚弱的心脏带来了巨大的压力。我妈妈每天早晚都为这件事哭泣。	触发性事件,触发性事件##社会关系
我一直觉得我这辈子都是别人的负担。	认知歪曲,认知歪曲##罪责归己/他
我觉得我这辈子都在让别人失望。	认知歪曲,认知歪曲##罪责归己/他
我从来没有参加过学校的运动队，我不受欢迎。	认知歪曲,认知歪曲##非此即彼
我的一生都让人失望，让人失望，现在我周围的一切都崩溃了。	认知歪曲,认知歪曲##情绪化推理
现在我想要带着我的朋友、家人和女朋友一起离去。	情绪反应,情绪反应##情感效应
我试图自杀未遂	情绪反应,情绪反应##行为效应
我的自尊心空前低落	情绪反应,情绪反应##情感效应
，但我太娇气了，害怕疼痛。	认知歪曲,认知歪曲##罪责归己/他
所以我只好吃点褪黑素，泡个没过下巴的澡	情绪反应,情绪反应##行为效应
我给每一个我爱的人都留了一张便条，也给警察或发现我尸体的人留了一张便条。	情绪反应,情绪反应##行为效应
她对我大吼大叫，说我自私，说我对我所拥有的生活不领情。她告诉了我爸爸，我又被他吼了。	触发性事件,触发性事件##社会关系
我的父母没收了我的手机	触发性事件,触发性事件##生活
我是最不受欢迎的孩子。	认知歪曲,认知歪曲##乱贴标签
我妈说了算，我爸可能喜欢我，我知道他觉得我很正派，但他不会阻止她。她只会大吼大叫，开各种冷嘲热讽的玩笑说我有多蠢，说我他妈比不上我哥哥，他他妈的各方面都很完美，而我甚至不会数学，不会电脑，什么都不会。	触发性事件,触发性事件##社会关系
我甚至不会数学，不会电脑，什么都不会。	认知歪曲,认知歪曲##以偏概全
我真的真的很没用，	认知歪曲,认知歪曲##乱贴标签
我真的真的很没用，我甚至不想再说什么了，因为我知道他们都比我聪明，我甚至不明白这是怎么回事。	认知歪曲,认知歪曲##妄下结论
但后来我父母告诉我，我只是个婊子，只是个粗鲁的混蛋，我不知道该怎么办。	触发性事件,触发性事件##社会关系
这一切以前都发生过，而且只会一次又一次地发生	认知歪曲,认知歪曲##妄下结论
多累、多沮丧、多孤独	情绪反应,情绪反应##情感效应
但有时我真的很想死	情绪反应,情绪反应##情感效应
我想消失	情绪反应,情绪反应##情感效应
我很痛苦。	情绪反应,情绪反应##情感效应
我的一生都是用来代替痛苦的。	认知歪曲,认知歪曲##情绪化推理
童年时期的情感虐待和精神虐待随处可见。	触发性事件,触发性事件##情感
一直一个人，所以我的社交生活从一开始就一团糟。	触发性事件,触发性事件##社会关系
我经常因为不喜欢运动或一些“正常”的东西而被置于嘲笑的位置。	触发性事件,触发性事件##社会关系
有一次我表现出了自杀的想法	情绪反应,情绪反应##情感效应
我父亲把我自己花钱买的个人电脑扔到墙上，说我很蠢	触发性事件,触发性事件##生活
我配不上任何人。我不是很好	认知歪曲,认知歪曲##罪责归己/他
最近我“最好”的朋友把我赶了出去	触发性事件,触发性事件##社会关系
我根本没有多少朋友。	认知歪曲,认知歪曲##以偏概全
我的成绩在下降。	触发性事件,触发性事件##学习工作
我的感情生活要完蛋了。	触发性事件,触发性事件##情感
我的朋友们都离开我了。	触发性事件,触发性事件##社会关系
我想结束这一切。	情绪反应,情绪反应##情感效应
我永远进不了医学院。我永远不会成为一名精神病医生。我永远不会成为一名顾问。	认知歪曲,认知歪曲##妄下结论
我真他妈丑。	认知歪曲,认知歪曲##情绪化推理
我只是应该消失。反正我对这破地方也没什么贡献。	认知歪曲,认知歪曲##情绪化推理
我看着我的梦想在我面前死去，现在我对未来没有任何希望。	认知歪曲,认知歪曲##情绪化推理
现在我对未来没有任何希望。	情绪反应,情绪反应##情感效应
几天前，我被诊断出患有一种疾病，无法获得飞行员执照，我意识到我的梦想破灭了。	触发性事件,触发性事件##学习工作
我以前也有过自杀和抑郁的念头	触发性事件,触发性事件##疾病症状
我真的觉得我没有什么活下去的意义了	情绪反应,情绪反应##情感效应
我没有女朋友，我没有一份好工作，我没有一个充满爱和关怀的家庭，我没有任何朋友，只有熟人。	认知歪曲,认知歪曲##情绪化推理
我又胖又受伤，没人愿意和我在一起超过几分钟。	认知歪曲,认知歪曲##情绪化推理
我没有什么可以依靠的。我什么都没有了。	认知歪曲,认知歪曲##妄下结论
我一直都很痛苦，而且会一直如此	认知歪曲,认知歪曲##情绪化推理
我一生中大部分时间都有慢性疼痛，而且一年比一年严重	触发性事件,触发性事件##疾病症状
医生对此没有解释，甚至没有尝试给我真正的治疗方法。	认知歪曲,认知歪曲##心理过滤
这样的生活让人愤怒和痛苦。	情绪反应,情绪反应##情感效应
我不能工作	触发性事件,触发性事件##学习工作
我功课不及格	触发性事件,触发性事件##学习工作
我不能和朋友一起做事情	触发性事件,触发性事件##社会关系
我准备今天放学回家就结束我的生命。	情绪反应,情绪反应##情感效应
我甚至永远不会接近。	认知歪曲,认知歪曲##妄下结论
我一直在努力争取完美的成绩，这让我难以承受。	触发性事件,触发性事件##学习工作
我几乎对一切都失去了兴趣	情绪反应,情绪反应##情感效应
我推开了我的朋友。	情绪反应,情绪反应##行为效应
我不是一个受欢迎的人	认知歪曲,认知歪曲##乱贴标签
我不是一个受欢迎的人，但我知道我的朋友会责怪自己，我的家庭会分裂	认知歪曲,认知歪曲##妄下结论
我会让很多人失望，我很抱歉。	认知歪曲,认知歪曲##罪责归己/他
想过吃药自杀	情绪反应,情绪反应##情感效应
我觉得跳江挺好的	情绪反应,情绪反应##情感效应
我经常失眠，两三点睡	情绪反应,情绪反应##行为效应
童年的阴影足以影响一个人的一生	触发性事件,触发性事件##生活
我不想再痛苦下去了。我没有活下去的理由。	情绪反应,情绪反应##情感效应
我睡不着。	情绪反应,情绪反应##行为效应
我大约一年前从大学退学了。	触发性事件,触发性事件##学习工作
我四个月前被解雇了。	触发性事件,触发性事件##学习工作
我把积蓄都花光了。我钱包里现在有十块钱，我是不是去买也没关系。	触发性事件,触发性事件##生活
我还是忘不了我的前女友。	触发性事件,触发性事件##情感
显然这对我的抑郁症没有帮助	触发性事件,触发性事件##疾病症状
这几年真是一团糟。当然，也有一些好事，但大多数都是坏事。	认知歪曲,认知歪曲##心理过滤
我没法保住工作。我不能交女朋友。我没有野心。	认知歪曲,认知歪曲##妄下结论
如果我死了，我就不会有任何问题	认知歪曲,认知歪曲##妄下结论
总比觉得自己一无是处要好。	认知歪曲,认知歪曲##乱贴标签
我想结束这一切	情绪反应,情绪反应##情感效应
压力正在杀死我。我已经很久没有自杀的念头了。	情绪反应,情绪反应##情感效应
我觉得自己很笨	认知歪曲,认知歪曲##罪责归己/他
我的工作节奏很快，让我筋疲力尽。	触发性事件,触发性事件##学习工作
学校也很糟糕，尽管我快完成学业了。	触发性事件,触发性事件##学习工作
还和妻子吵架。	触发性事件,触发性事件##社会关系
我总是感到迷茫，我很容易生气。我感觉心碎了	情绪反应,情绪反应##情感效应
我们每天都在吵架。	情绪反应,情绪反应##行为效应
我一直在想自杀的事。	情绪反应,情绪反应##情感效应
我似乎不快乐。	情绪反应,情绪反应##情感效应
我有枪，我有很多活下去的理由，但无论如何，我的死的理由总会出现。	认知歪曲,认知歪曲##心理过滤
我深爱着她，持续了11个月，但我离开了她。	触发性事件,触发性事件##情感
我父亲因谋杀未遂入狱	触发性事件,触发性事件##社会关系
我忍不住觉得这一切都是我造成的，我忍不住觉得我妈妈现在也是因为我才染上了毒瘾。	认知歪曲,认知歪曲##罪责归己/他
我的生活一团糟，我生活在地狱里，我无法摆脱自杀的念头。	认知歪曲,认知歪曲##情绪化推理
我高中不及格，	触发性事件,触发性事件##学习工作
我高中不及格，我所有的同龄人都讨厌我，	认知歪曲,认知歪曲##以偏概全
脑子想的都是自杀，	情绪反应,情绪反应##情感效应
我就想自杀。	情绪反应,情绪反应##情感效应
我的家人会对我大喊大叫，斥责我，说我不够好。我妈总是因为我做蠢事而对我大吼大叫。	触发性事件,触发性事件##社会关系
我已经不能正常饮食了	情绪反应,情绪反应##行为效应
我已经不能正常饮食了，而且我也因此被人吼了。	触发性事件,触发性事件##生活
我通常会麻木，	情绪反应,情绪反应##情感效应
我把自己置于有毒或不健康的关系中，并继续承担所有的责任。	认知歪曲,认知歪曲##妄下结论
不管是不是我的错，我都承担责任。	认知歪曲,认知歪曲##罪责归己/他
抑郁症	触发性事件,触发性事件##疾病症状
因为这次隔离，我不能去。	触发性事件,触发性事件##生活
结果却是另一个巨大的失望。	触发性事件,触发性事件##情感
我没有眼泪了。	认知歪曲,认知歪曲##情绪化推理
告诉我我是个失败者。	认知歪曲,认知歪曲##罪责归己/他
失败者	认知歪曲,认知歪曲##乱贴标签
有人会爱我，我不值得任何人的时间和精力。	认知歪曲,认知歪曲##妄下结论
不上任何人。	认知歪曲,认知歪曲##罪责归己/他
我想死，我想死。	情绪反应,情绪反应##情感效应
我就不用假装喜欢任何人了。我不会有任何情绪，我不会一次又一次地崩溃。	认知歪曲,认知歪曲##妄下结论
我尝试过六次自杀	情绪反应,情绪反应##行为效应
我只想死，我很害怕	情绪反应,情绪反应##情感效应
我被诊断出患有抑郁症和焦虑症。	触发性事件,触发性事件##疾病症状
法集中精力学习和做作业	触发性事件,触发性事件##学习工作
我的初恋去世了	触发性事件,触发性事件##情感
我在大学的终极项目已经失败了。	触发性事件,触发性事件##学习工作
我还在找工作，不过说真的，我已经放弃了。	触发性事件,触发性事件##学习工作
我将一事无成。我永远无法在我的领域工作，即使我能在我的领域找到工作，我也不会喜欢它。	认知歪曲,认知歪曲##妄下结论
如果我能奇迹般地画出一些东西，它看起来就像一坨屎。	认知歪曲,认知歪曲##心理过滤
我被诊断出患有一种慢性身体疾病	情绪反应,情绪反应##情感效应
我没用。	认知歪曲,认知歪曲##罪责归己/他
我耗尽了我父母的资源。	认知歪曲,认知歪曲##放大和缩小
我耗尽了我父母的资源。我永远找不到我喜欢的工作。我的爱好不再有趣了。没有什么能吸引我的注意力。	认知歪曲,认知歪曲##妄下结论
我的下半辈子都要在某种医学上度过了。	认知歪曲,认知歪曲##妄下结论
如果没有我，世界会更好，如果我不存在，世界会更好。	认知歪曲,认知歪曲##妄下结论
痛苦、无用和绝望	情绪反应,情绪反应##情感效应
我负担不起再住院了。	触发性事件,触发性事件##生活
，但这让我很害怕	情绪反应,情绪反应##情感效应
因为我害怕他们会把我永远关起来，我只想结束这一切。	认知歪曲,认知歪曲##妄下结论
，我用围巾再次想要自杀	情绪反应,情绪反应##行为效应
觉得自己有点凄凉	情绪反应,情绪反应##情感效应
我16岁，我想自杀。	情绪反应,情绪反应##情感效应
我的父母认为我是个负担，拒绝让我得到帮助。	触发性事件,触发性事件##社会关系
我13岁时曾试图自杀	情绪反应,情绪反应##行为效应
除了那个在我15岁时给我上过床的26岁男人外，我没有任何朋友。	触发性事件,触发性事件##社会关系
我感到很失落，很不值得。	情绪反应,情绪反应##情感效应
我割大腿已经有一段时间了	情绪反应,情绪反应##行为效应
我认为正确的做法是割开我的喉咙或割开我的腿	认知歪曲,认知歪曲##情绪化推理
我母亲去世了	触发性事件,触发性事件##社会关系
一个月后，我叔叔去世了，又过了一个月，我祖母也去世了。	触发性事件,触发性事件##社会关系
我搬到了纽约	触发性事件,触发性事件##生活
我把学校搞砸了(我才23岁，连基础的大学都上不了)，我又懒又笨	认知歪曲,认知歪曲##妄下结论
我是周围人的累赘	认知歪曲,认知歪曲##乱贴标签
每一天我都在想结束自己的生命	情绪反应,情绪反应##情感效应
我去看过心理学家和精神科医生，但到目前为止都没有什么效果。	情绪反应,情绪反应##行为效应
我知道这会伤害我的女朋友、父亲和祖父。到目前为止，这是我还没有做的唯一原因	驳斥,驳斥##有效驳斥
我是功能性弱智。	触发性事件,触发性事件##疾病症状
我应该放弃	认知歪曲,认知歪曲##应该句式
因此，在社交上失败了。去年年底，我失去了一段感情，	触发性事件,触发性事件##情感
我开始滥用处方药安必恩(Ambien)和酒精	情绪反应,情绪反应##行为效应
有人说我很自负，但当我对自己拥有的品质进行盘点时，没有任何东西能支持这种妄想的自爱。	认知歪曲,认知歪曲##心理过滤
意识到这些事情的总和，我在学习、社交场合和如何评价自己方面都非常糟糕，	认知歪曲,认知歪曲##否定正面思考
我经常想到自杀	情绪反应,情绪反应##情感效应
这不会解决任何问题，但肯定也不会成为别人的负担	驳斥,驳斥##习惯性驳斥
我去年病得很重	触发性事件,触发性事件##疾病症状
失业了	触发性事件,触发性事件##学习工作
失去房子	触发性事件,触发性事件##生活
婚姻触礁	触发性事件,触发性事件##情感
我经常想自杀	情绪反应,情绪反应##情感效应
唯一阻止我的是害怕我搞砸了，最后沦落到像个植物人一样的通风口上	驳斥,驳斥##有效驳斥
我失去了继续下去的意愿	情绪反应,情绪反应##情感效应
我只是厌倦了日复一日的琐事。厌倦了失败。厌倦了被激怒和被激怒。	认知歪曲,认知歪曲##心理过滤
如果我现在可以吃一片药，并且百分之百确定它会结束我的生命，我就会这么做。	情绪反应,情绪反应##情感效应
我觉得一切都结束了	认知歪曲,认知歪曲##以偏概全
我刚满26岁，我觉得这一切都是浪费。	认知歪曲,认知歪曲##以偏概全
自从我朋友去世后	触发性事件,触发性事件##社会关系
我有一年断断续续有自杀倾向，在那之前我就有过自杀倾向。	情绪反应,情绪反应##情感效应
不想和任何人在一起。即使在团队中，我也觉得自己是个局外人。现在已经到了我感觉不到任何东西的地步了	认知歪曲,认知歪曲##心理过滤
我不能哭，不能尖叫，不能叫喊，甚至不能对我的处境做出反应，我只是一个壳，等着死。	情绪反应,情绪反应##情感效应
我觉得每个人随时都可能背叛我。	认知歪曲,认知歪曲##情绪化推理
任何我认识的人，我都不相信他们说我们之间一切都很好。	认知歪曲,认知歪曲##情绪化推理
我对自己做的任何事都没有信心	认知歪曲,认知歪曲##否定正面思考
我在工作中搞砸了很多，每天都被骂，工作日工作16个小时，周末工作8到12个小时。	触发性事件,触发性事件##学习工作
我觉得除了当律师，我什么都做不了	认知歪曲,认知歪曲##妄下结论
因为我认识的其他人，同事和法学院的朋友，似乎都能很好地处理他们的工作	认知歪曲,认知歪曲##放大和缩小
我没有时间和朋友或家人在一起，在过去的几个月里，我唯一说过话的人都是同事	触发性事件,触发性事件##生活
我觉得我不应该抱怨，因为我有一份不错的薪水。	认知歪曲,认知歪曲##应该句式
我觉得自己毫无价值，没有动力去做任何事情。	认知歪曲,认知歪曲##以偏概全
我也是同性恋	触发性事件,触发性事件##情感
十几岁的时候曾想过自杀	情绪反应,情绪反应##情感效应
所有这些关于自杀的想法又回到我的脑海里，我感到害怕，这种熟悉的痛苦又开始悄悄回到我的生活中	情绪反应,情绪反应##情感效应
我觉得我要崩溃了，但我不想。我父母现在需要我，所以我一直告诉自己要为了他们坚强起来，但我也太累了。	驳斥,驳斥##有效驳斥
我伤害了我最关心的人。	触发性事件,触发性事件##情感
生活已经失去了意义，我看不出有什么办法可以变得更好。	认知歪曲,认知歪曲##非此即彼
我没有未来，也无法摆脱它只是从我身上夺走的感觉	认知歪曲,认知歪曲##妄下结论
因为我是一个狗屎人	认知歪曲,认知歪曲##乱贴标签
不能自杀	情绪反应,情绪反应##情感效应
我有一个经常虐待我的男朋友。	触发性事件,触发性事件##生活
即使我在学校，无论我多么友好，我的同学似乎都对我畏缩不前。	认知歪曲,认知歪曲##非此即彼
我觉得如果我不在这里，一切可能会更好。	认知歪曲,认知歪曲##情绪化推理
我坐在这里想着自杀的方法	情绪反应,情绪反应##情感效应
因为我觉得我在这个世界上没有立足之地。	认知歪曲,认知歪曲##情绪化推理
我的一生中有过吸毒成瘾的父母，有过脱衣和卖淫的经历	触发性事件,触发性事件##社会关系
我希望这些不好的想法能消失。	驳斥,驳斥##有效驳斥
过着幸福的生活，结了婚，生了个女儿……一个真正的公主，她现在6岁了。	触发性事件,触发性事件##生活
结了婚，生了个女儿	触发性事件,触发性事件##社会关系
直到一年前的某一天，我搞砸了一切	认知歪曲,认知歪曲##以偏概全
我的妻子带着我的女儿离开了我.	触发性事件,触发性事件##生活
我现在欠了5000美元的债，	触发性事件,触发性事件##生活
失去了婚姻	触发性事件,触发性事件##情感
失去了女儿	触发性事件,触发性事件##社会关系
想着如何结束自己的生命。	情绪反应,情绪反应##行为效应
我住在8楼，如果我跳下去会吓到下面的一群人。	驳斥,驳斥##有效驳斥
所以我正在考虑服用大约30片安定和20片安必恩的混合物。	情绪反应,情绪反应##情感效应
我的男朋友引发了我的自杀念头	触发性事件,触发性事件##情感
他，因为他总是和我分手	触发性事件,触发性事件##情感
我告诉了他我欠了多少债，他没告诉我	触发性事件,触发性事件##生活
如果我把钱花在任何不必要的东西上，或者他认为浪费的东西上，他就会和我分手。他还要求我减肥。太可怜了，我当然屈服于他爸爸了，因为我不想要他。离开我。他还是对我态度，说他不想说话。对我来说，因为他觉得我恶心。	触发性事件,触发性事件##生活
我在开车回家的路上，感觉非常有动力完成我的论文，他给我发了信息。我的心情瞬间改变了。我感到羞愧和愤怒。我们说得越多，我的情绪就越糟。他想要一切都按照他的方式来，当我礼貌地说我今晚不想发言，这样我就可以在正确的头脑空间里完成任务时，他说我是懦夫。说我是他见过的最自私的人。这很有趣，因为他自己在过去的10年里一直在与抑郁症作斗争，结果在那段时间里没有找到工作，也没有完成他的学位。我甚至特意帮他上大学，整晚都在帮他做作业。	触发性事件,触发性事件##生活
他真的让我想自杀。	情绪反应,情绪反应##情感效应
当他贬低我的时候，我觉得我对社会或别人的生活没有什么可贡献的。	认知歪曲,认知歪曲##罪责归己/他
我真希望我已经死了，这样我就不用承受这些痛苦了	情绪反应,情绪反应##情感效应
怕爸妈伤心，所以走一步算一步，	驳斥,驳斥##有效驳斥
我查过好多死法，	情绪反应,情绪反应##行为效应
所以我又是胆小鬼	认知歪曲,认知歪曲##乱贴标签
唯一能阻止我的是，它会伤害我，我可能有潜力熬过这一切，直到最后，和一个爱我/关心我的人一起过上美好的生活	驳斥,驳斥##有效驳斥
我母亲就开始辱骂我	触发性事件,触发性事件##生活
从我那么大的时候起，她就一直在谈论经济问题、我爸爸、我们破碎的家庭、对自己讨厌生活的负面抱怨和其他不好的事情，基本上一直在操纵我的思路和自尊	触发性事件,触发性事件##生活
我觉得自己像个异类，	认知歪曲,认知歪曲##乱贴标签
我是一个负担，	认知歪曲,认知歪曲##乱贴标签
我只想死	情绪反应,情绪反应##情感效应
我厌倦了这种生活，我希望我已经死了。	情绪反应,情绪反应##情感效应
我一直在想自杀	情绪反应,情绪反应##情感效应
我有一个充满爱的支持我的妈妈、爸爸和哥哥	触发性事件,触发性事件##情感
然而我的家庭却充满了压力、怨恨和焦虑	触发性事件,触发性事件##情感
我小时候被虐待过	触发性事件,触发性事件##生活
我的父母似乎并不怎么关心我	触发性事件,触发性事件##社会关系
但他是个正常的人，有很多朋友，而我一个朋友也没有。我从未感到如此孤独，从未如此憎恨自己。	认知歪曲,认知歪曲##放大和缩小
我甚至不再试着和女孩说话了因为我知道我长得太丑了，再试也没有意义了。	认知歪曲,认知歪曲##妄下结论
这样我的家人就不会担心，因为他们都是好人，他们不应该像我这样背负负担。	认知歪曲,认知歪曲##罪责归己/他
我曾经有过三次自杀的计划，其中一次真的实现了	情绪反应,情绪反应##行为效应
我就会立刻想到自杀。	情绪反应,情绪反应##情感效应
我不想这么做的唯一原因是我的家人因为我知道这会对他们造成多大的影响，因为他们一直告诉我，如果我自杀，他们永远不会原谅我，永远不会继续生活，他们的生活将永远被毁	驳斥,驳斥##有效驳斥
我和交往已久的高中女友分手了。	触发性事件,触发性事件##情感
她不想让我再抽大麻了，所以我戒了	触发性事件,触发性事件##生活
我们分手后	触发性事件,触发性事件##情感
我每天都抽烟，持续了大约7个月，尝试了各种各样的新药，香烟、酒精、鸦片、LSD、摇头丸、可卡因。	触发性事件,触发性事件##生活
那时候我开始吸毒了。	触发性事件,触发性事件##生活
选择在距离家乡300英里的地方上大学，努力重新开始	触发性事件,触发性事件##学习工作
有钱，我的一些重要课程快要挂科了，我一无所有。	认知歪曲,认知歪曲##以偏概全
我试着怪别人把我变成了怪物，但唯一该怪的人是我自己。	认知歪曲,认知歪曲##罪责归己/他
在我试图自杀之后	情绪反应,情绪反应##行为效应
我最后确实逃到了城市	触发性事件,触发性事件##生活
从我所在的费城向南走了40英里。我要么在毒品中迷失，要么自杀，我还不确定是什么	情绪反应,情绪反应##行为效应
我失去了很多朋友	触发性事件,触发性事件##情感
我现在和我的前男友和他的家人住在一起，直到我找到自己的房子	触发性事件,触发性事件##生活
我再也找不到可以倾诉的人了。	认知歪曲,认知歪曲##以偏概全
我觉得自己是个负担。	认知歪曲,认知歪曲##乱贴标签
我觉得没有我大家会过得更好。	认知歪曲,认知歪曲##情绪化推理
昨晚我试图自杀，但没有成功。	情绪反应,情绪反应##行为效应
我爸爸今年1月3日去世了	触发性事件,触发性事件##社会关系
我学会了开车，参加了舞会，高中毕业，上了大学	触发性事件,触发性事件##生活
我很确定我的男朋友已经厌倦了我一贯令人沮丧的举止	认知歪曲,认知歪曲##妄下结论
我已经准备好离开了。	情绪反应,情绪反应##行为效应
我肯定我看起来像条死鱼。	认知歪曲,认知歪曲##乱贴标签
我又哭又怕，不是因为我快死了，而是因为我听到他们说要把我送到一个研究所，而我根本不想去	情绪反应,情绪反应##情感效应
我知道我太过分了。我不怪他。但我感觉被背叛了。	认知歪曲,认知歪曲##罪责归己/他
我需要他，但我觉得他让我滚蛋。我不怪他，	认知歪曲,认知歪曲##情绪化推理
这位朋友，也是男友最好的朋友	触发性事件,触发性事件##社会关系
他不在这里，我在这里让大家压力很大。	认知歪曲,认知歪曲##罪责归己/他
我已经厌倦了想念别人和一个我知道我永远不会拥有的未来。	认知歪曲,认知歪曲##妄下结论
我曾试图自杀，	情绪反应,情绪反应##行为效应
除了几个月的自残之外	情绪反应,情绪反应##行为效应
我的情绪得到了一些控制	情绪反应,情绪反应##情感效应
我和交往了两年的男朋友分手了	触发性事件,触发性事件##情感
我会整天躲在房间里	触发性事件,触发性事件##生活
我经常因为懒惰而几天不吃东西。	触发性事件,触发性事件##生活
结果我的成绩糟透了，一门课得了D，另一门课得了C，	触发性事件,触发性事件##学习工作
看在家人的份上，我打算等到假期结束……但我真的不能再这样下去了，因为我这样让家人失望了	驳斥,驳斥##有效驳斥
我不配活下去，	认知歪曲,认知歪曲##非此即彼
我毁了自己。	认知歪曲,认知歪曲##罪责归己/他
想自杀，我不怕，但是从小到大的家庭教育让我不能	驳斥,驳斥##有效驳斥
很小的时候父母就离婚了	触发性事件,触发性事件##社会关系
身边的人都在可怜我，	认知歪曲,认知歪曲##情绪化推理
大学的时候找了个男朋友，他的妈妈知道我师傅单亲以后第一个想法是单亲家庭的孩子都有问题，	触发性事件,触发性事件##情感
我小时候学习特别好，	触发性事件,触发性事件##学习工作
但是那个时候真的觉得大家都在欺负我。	认知歪曲,认知歪曲##心理过滤
一直是年级前几名	触发性事件,触发性事件##学习工作
她一边像我表达着有多么关心我，一边引导着我们班女生既可怜我又排斥我，说我长大以后肯定为男人犯错，不爱惜自己，贱…呵	触发性事件,触发性事件##社会关系
爸当初说我要是不想念书趁早说，赶紧把我卖到山里找个人家嫁了得	触发性事件,触发性事件##社会关系
除了我的成绩一直在下降以外	触发性事件,触发性事件##学习工作
我辞掉了送外卖的工作	触发性事件,触发性事件##学习工作
撞坏了两辆车	触发性事件,触发性事件##生活
我去年打了5份工，我赚了近8000美元	触发性事件,触发性事件##生活
我17岁的时候有了一个孩子	触发性事件,触发性事件##社会关系
因为我约会的男孩强奸并虐待我，我不能堕胎	触发性事件,触发性事件##情感
我真的认为如果他不亲手杀了我，他会找别人来做的	认知歪曲,认知歪曲##妄下结论
我大学第一学期不及格	触发性事件,触发性事件##学习工作
想从桥上跳下去	情绪反应,情绪反应##情感效应
我总共住过6次院，自杀次数超过10次。	情绪反应,情绪反应##行为效应
一切似乎都没有好转	认知歪曲,认知歪曲##非此即彼
每次我试图做一些事情来解决我的情况，它适得其反，使一切变得更糟。	认知歪曲,认知歪曲##以偏概全
我把我的生活搞得一团糟，	认知歪曲,认知歪曲##罪责归己/他
我在考虑再结束一次，这次更彻底。	情绪反应,情绪反应##情感效应
网上查了各种自杀方式，最后选择了吃安眠药，	情绪反应,情绪反应##行为效应
我只是想说再见。	情绪反应,情绪反应##情感效应
我发现今天我申请的工作被别人得到了	触发性事件,触发性事件##学习工作
我厌倦了人们对我的态度。	触发性事件,触发性事件##社会关系
我已经厌倦了在街上住了7年。我厌倦了所有的时间和精力，我试图学习新的东西，只是没有人给我一个机会。	触发性事件,触发性事件##生活
我受够了那些我负担不起的健康问题	触发性事件,触发性事件##疾病症状
因为我在这个世界上没有可行的未来	认知歪曲,认知歪曲##非此即彼
即使情况有所好转，也不会一直好下去	认知歪曲,认知歪曲##否定正面思考
我没有亲人可以打电话，也没有朋友	触发性事件,触发性事件##社会关系
再见	情绪反应,情绪反应##行为效应
我一直在努力改善自己的心理健康状况，	驳斥,驳斥##有效驳斥
我赚的钱不够了;	触发性事件,触发性事件##生活
这让我觉得自己像个失败者	认知歪曲,认知歪曲##乱贴标签
我妈妈正在恶化我的精神健康，她现在失业了	触发性事件,触发性事件##社会关系
把我的问题当作鸡毛蒜皮的废话，表现得好像她不允许我搬出去	认知歪曲,认知歪曲##心理过滤
我的车现在也刚好坏了	触发性事件,触发性事件##生活
我想割伤自己	情绪反应,情绪反应##情感效应
生活开始好转，然后发生了一些事情，让我比以前更沮丧。	认知歪曲,认知歪曲##否定正面思考
是时候自杀了	情绪反应,情绪反应##行为效应
割破我的脸和手腕	情绪反应,情绪反应##行为效应
我决定暂时把注意力集中在自己身上，我办了健身房会员，还剪了头发…	驳斥,驳斥##有效驳斥
人们现在经常看我，所以我想这是需要习惯的。	驳斥,驳斥##有效驳斥
我还是有自残的冲动，	情绪反应,情绪反应##情感效应
性虐待几乎主宰了我的整个高中生活	触发性事件,触发性事件##生活
我每天都受到酷刑和强奸的威胁	触发性事件,触发性事件##情感
我仍然很沮丧，但现在我有一点躁狂的能量	触发性事件,触发性事件##疾病症状
我的精神病让我每天都在自残	情绪反应,情绪反应##行为效应
我第一次试图自杀	情绪反应,情绪反应##行为效应
但有些人永远无法达到幸福	认知歪曲,认知歪曲##非此即彼
我孤身一人。我所有的朋友都抛弃了我，我只是他们的累赘	认知歪曲,认知歪曲##罪责归己/他
但我能感觉到我是一个负担	认知歪曲,认知歪曲##情绪化推理
每个人总是离开我	认知歪曲,认知歪曲##以偏概全
告诉我我可以恢复。但他们不知道。他们不可能理解	认知歪曲,认知歪曲##否定正面思考
我放了我最喜欢的电影，拿出剃刀，现在是它的表现时间。	情绪反应,情绪反应##行为效应
我爸把我送进精神军事学校	触发性事件,触发性事件##生活
仍然有自杀的想法，	情绪反应,情绪反应##行为效应
没人的时候拿头撞墙，用教官抽完的烟烫烟疤，用阿姨缝被子的针扎自己。	情绪反应,情绪反应##行为效应
我就一直在与抑郁症和自杀念头作斗争	触发性事件,触发性事件##疾病症状
我情绪很低落，为此我感到很虚弱	触发性事件,触发性事件##疾病症状
我一直在想和男朋友分手	触发性事件,触发性事件##情感
但我一直想自杀，	情绪反应,情绪反应##情感效应
我的焦虑非常严重	触发性事件,触发性事件##疾病症状
我总是选择不去和他们一起做事	触发性事件,触发性事件##社会关系
我觉得他们不喜欢我，觉得我很烦人，很恶毒	认知歪曲,认知歪曲##情绪化推理
伤了自己	情绪反应,情绪反应##行为效应
我恨我自己。我觉得自己一无是处。	认知歪曲,认知歪曲##以偏概全
我的朋友们今晚要出去庆祝生日，我在最后一刻没有参加	触发性事件,触发性事件##社会关系
我觉得我太自私了	认知歪曲,认知歪曲##非此即彼
所以我一直在想我怎么能自杀	情绪反应,情绪反应##情感效应
我有严重的抑郁、焦虑/恐慌症，有时还会幻听	触发性事件,触发性事件##疾病症状
我已经很长时间没有和任何人面对面了	触发性事件,触发性事件##社会关系
情绪低落	触发性事件,触发性事件##疾病症状
他主动提出要打电话给我	触发性事件,触发性事件##社会关系
我觉得我不应该生气，	认知歪曲,认知歪曲##应该句式
因为我不应该期望太多，	认知歪曲,认知歪曲##应该句式
现在似乎当我需要帮助的时候，没有人在那里。	认知歪曲,认知歪曲##心理过滤
我仍然有自杀的计划	情绪反应,情绪反应##情感效应
我在8月份被解雇了，经过100多份申请，职业指导，专业的简历，到目前为止没有任何工作经历，在同一家公司工作了13年，还有一些职位的推荐，我仍然没有希望。	触发性事件,触发性事件##学习工作
我对我的家庭毫无贡献	认知歪曲,认知歪曲##妄下结论
我没有提供任何经济和情感上的帮助	触发性事件,触发性事件##情感
我和我的朋友们保持距离	触发性事件,触发性事件##社会关系
妈妈去年8月去世了	触发性事件,触发性事件##社会关系
两周后爸爸被诊断出癌症，几周后他又被诊断出另一种癌症	触发性事件,触发性事件##社会关系
我厌倦了等待下一件坏事发生，	认知歪曲,认知歪曲##情绪化推理
厌倦了成为家庭经济和情感上的负担。	认知歪曲,认知歪曲##罪责归己/他
前几天我割伤了左手腕	情绪反应,情绪反应##行为效应
我18岁，在一所不错的学校上大学。我一直对自己的人生有规划。我想大学毕业，成为一名商业航空公司的飞行员，娶我唯一爱过的女孩	触发性事件,触发性事件##学习工作
唯一让我开心的事情就是和我女朋友在一起的时候，	认知歪曲,认知歪曲##以偏概全
她决定离开我，现在她又和她的前男友在一起	触发性事件,触发性事件##社会关系
除了我的几个朋友，我现在没有理由活下去了。	认知歪曲,认知歪曲##否定正面思考
我抓住腰带系在脖子上，然后把它关在门里，我身体前倾，开始昏倒，这是一种自然反应，我想伸手打开门，以免自己死去。	情绪反应,情绪反应##行为效应
一直到我脖子套在了绳子上	情绪反应,情绪反应##行为效应
我妈妈还是没有出现，我在想为什么她可以为了赌气了就和爸爸结婚	触发性事件,触发性事件##生活
甚至要生下我来绑住爸爸	认知歪曲,认知歪曲##罪责归己/他
每当我很绝望的时候	触发性事件,触发性事件##情感
其实都有想死的欲望	情绪反应,情绪反应##情感效应
但我总是会想到我爸妈他们已经老了，我比他们小了30岁，想到如果我死在他们前面了，他们那种可怜的模样就会让我好难受。	驳斥,驳斥##习惯性驳斥
自杀挺酷的，多有范啊，那是自由的表率。	认知歪曲,认知歪曲##妄下结论
我甚至还想过在坐飞机的路上找一条江什么的跳下去一死了之的了	情绪反应,情绪反应##情感效应
另一方面也是怕我妈妈伤心，我怕我爸爸会打我妈妈。	认知歪曲,认知歪曲##罪责归己/他
可是自从上了大二，压力突然像潮水般涌来，学业，家庭，比赛	触发性事件,触发性事件##学习工作
人际关系	触发性事件,触发性事件##社会关系
我感觉好累啊，不是身体那种累，就是心累	触发性事件,触发性事件##情感
可是每次到夜深人静的时候，那种压力在寂静的黑夜就向你扑来，无处可躲	认知歪曲,认知歪曲##放大和缩小
想着死了就放松了，开始预谋自杀。	情绪反应,情绪反应##情感效应
高中自杀没有成功。	情绪反应,情绪反应##行为效应
其实活到快大学毕业仍然没有多顺利，也自残过，被弟弟阻止了。	认知歪曲,认知歪曲##否定正面思考,情绪反应,情绪反应##行为效应
我不知道我现在的心是不是好像木头一样都没有感觉。	认知歪曲,认知歪曲##情绪化推理
就算认真做什么也还是觉得我不好，丢人，自我认同感真的也不高。	认知歪曲,认知歪曲##罪责归己/他
我可能就是废人，可是那又怎么样呢？	认知歪曲,认知歪曲##心理过滤,认知歪曲,认知歪曲##乱贴标签
我性格怪异不合群，三观不正学习挺好，但没有人理解。	触发性事件,触发性事件##生活,认知歪曲,认知歪曲##心理过滤
亲情和友情就像毒药，有爱却总是误解，想活也活不下去，所以就自杀了。	认知歪曲,认知歪曲##以偏概全,情绪反应,情绪反应##行为效应
最后就条件反射了，渐渐的生活也是条件反射，情感以及他人感受已经从我的认知范围消失了，想问题的时候总是想不起来	认知歪曲,认知歪曲##以偏概全
再后来自己的未来和自己的身体最后也从认知范围内消失了，想不起来了，别人都以为我自甘堕落不明事理，认为我变坏了。	认知歪曲,认知歪曲##妄下结论,认知歪曲,认知歪曲##放大和缩小
那时好伤心好孤单啊，就这样天天想着死就这样死了	情绪反应,情绪反应##情感效应
虽然没死成，但依旧一心向死，学也不上了整天被人骂。	认知歪曲,认知歪曲##放大和缩小
我又割伤了自己	情绪反应,情绪反应##行为效应
我希望9年的性侵足以让我的家人把他赶出去。	触发性事件,触发性事件##生活
我希望他们永远不要取笑我的抑郁症	触发性事件,触发性事件##疾病症状
我真希望我妈在我出柜是双性恋的时候从没说过我让人难堪。我希望学校没有把我企图自杀的事告诉所有人。	触发性事件,触发性事件##生活
这让我每天都很难过，我希望每个人都知道我的家人经常让我伤心。	情绪反应,情绪反应##情感效应
我希望每个人都知道我从初中到高三都在和厌食症作斗争。	触发性事件,触发性事件##生活
我好孤单	情绪反应,情绪反应##情感效应
因为我总是以受伤告终。	认知歪曲,认知歪曲##以偏概全
死也不会有人爱我。	认知歪曲,认知歪曲##否定正面思考
每次我想做点什么，我都搞砸了。	认知歪曲,认知歪曲##否定正面思考
我被职业学校开除了因为他们知道我因为骚扰而自残。	情绪反应,情绪反应##行为效应
我的驾驶考试总是不及格。	触发性事件,触发性事件##学习工作
我太蠢了，找不到工作，就算找得到，最低工资也买不起公寓，更买不起荷尔蒙。	触发性事件,触发性事件##学习工作
每次我想要改善我的生活，却失败了。	认知歪曲,认知歪曲##以偏概全
没有什么留给我的了。	认知歪曲,认知歪曲##妄下结论
因为没有女孩愿意和一个看起来不像女人的又胖又失业的女人约会。	认知歪曲,认知歪曲##乱贴标签
我没有活下去的理由	认知歪曲,认知歪曲##妄下结论
我不想死，但在这一点上，这比继续活着要痛苦得多	驳斥,驳斥##有效驳斥
我永远无法成为我想成为的人	认知歪曲,认知歪曲##罪责归己/他
我觉得很丢脸，	情绪反应,情绪反应##情感效应
我的生活似乎在我眼前分崩离析。	触发性事件,触发性事件##生活
我最好的朋友讨厌我小气，没价值的事，在我最需要别人的时候离开了我。	触发性事件,触发性事件##社会关系
我的朋友开始疏远我，我的父母对我很失望，	触发性事件,触发性事件##生活
我的成绩很糟糕，	触发性事件,触发性事件##学习工作
我有可怕的恐慌症和严重的强迫症。	触发性事件,触发性事件##疾病症状
我讨厌自己的一切，我觉得自己是周围每个人的负担。	认知歪曲,认知歪曲##否定正面思考
我心中充满了遗憾和悲伤。	情绪反应,情绪反应##情感效应
我似乎把我周围的人都打倒了，这让我感觉更糟。	认知歪曲,认知歪曲##以偏概全
我只是想让每个人都开心，而不是被人踩着走。我想在生活中做我喜欢的事情，而不是服从和做一份会让事情变得更糟的工作。	驳斥,驳斥##有效驳斥
说实话，我已经制定了详细的计划来结束这一切。	情绪反应,情绪反应##行为效应
我很想再试一次。	情绪反应,情绪反应##行为效应
好像再也没人在乎我了。	认知歪曲,认知歪曲##否定正面思考
最后死！	情绪反应,情绪反应##行为效应
还有什么理由让我活下去？	驳斥,驳斥##习惯性驳斥
我实在是看不到希望	认知歪曲,认知歪曲##否定正面思考
我永远都过不上我想要的生活！	认知歪曲,认知歪曲##妄下结论
我试过上吊自杀，一天服用8000毫克对乙酰氨基酚。	情绪反应,情绪反应##行为效应
我睡得太多了每次醒来，我都很失望我还没死。	认知歪曲,认知歪曲##否定正面思考
拖延了两年的大学第一学期刚刚以精神崩溃和错过考试的结局结束，这占了课程成绩的40%。	触发性事件,触发性事件##学习工作
我已经准备好结束我的生命了。	情绪反应,情绪反应##行为效应
两年前我去了另一所大学，出于同样的原因我不得不离开。	触发性事件,触发性事件##学习工作
都是我的错。	认知歪曲,认知歪曲##罪责归己/他
我是一个有毒的人	认知歪曲,认知歪曲##乱贴标签
我被诊断出患有BPD，	触发性事件,触发性事件##疾病症状
我最亲密的朋友是我的前任，他在我的康复过程中非常支持我，尽管在我们关系结束的时候，我经常深深地伤害了他，直到今天我仍然对此感到懊悔。	触发性事件,触发性事件##情感
这件事之所以重要，是因为我们都曾计划在未来再次在一起，但我觉得现在我毁了一切。	触发性事件,触发性事件##情感
这让我很伤心，	情绪反应,情绪反应##情感效应
我认为我永远不会康复。	认知歪曲,认知歪曲##否定正面思考
我有药，但不足以致命。	情绪反应,情绪反应##行为效应
一大早我就会服用可待因，然后跳下去	情绪反应,情绪反应##行为效应
我很快就要走了。我很快就要结束我的生命了。	情绪反应,情绪反应##行为效应
我已经失去了所有的希望。	认知歪曲,认知歪曲##妄下结论
我在公立学校上了很多年，从10年级开始，我一直在家上学，在我的中学时代，我被欺负得很厉害。	触发性事件,触发性事件##学习工作
我觉得很孤独，毫无价值，	情绪反应,情绪反应##情感效应
我有边缘性人格障碍，抑郁，焦虑，	触发性事件,触发性事件##疾病症状
我父母不支持我这么做。我表现出任何精神疾病的迹象，他们都不关心我。	触发性事件,触发性事件##生活
我现在住的地方有很多树，我想过在一棵树上上吊自杀。我爸爸有多把枪，我可以用一把，但我想我没有足够的勇气扣动扳机。	情绪反应,情绪反应##行为效应
我永远不会快乐，我永远不会满足。我是个负担。	认知歪曲,认知歪曲##妄下结论
当我年轻的时候，我有一个“男朋友”?	触发性事件,触发性事件##情感
但我从未真正体验过爱，而且我觉得我永远也不会。	认知歪曲,认知歪曲##否定正面思考
我什么都不是。	认知歪曲,认知歪曲##妄下结论
我很痛苦，很受伤，	情绪反应,情绪反应##情感效应
自杀已经在我的脑海里萦绕了好几个月了，	情绪反应,情绪反应##行为效应
我从9岁就开始自残了，	情绪反应,情绪反应##行为效应
我又要自残了。我总是会再次陷入其中，我的大腿上布满了伤疤。	情绪反应,情绪反应##行为效应
所以我买了一克海洛因来吸食。	情绪反应,情绪反应##行为效应
当我7岁的时候，我的堂兄弟姐妹说他们会照看我，但我没有这样做，我被5个男人轮奸，几个月后我被我妹妹猥亵。	触发性事件,触发性事件##生活
最重要的是，在我成长的过程中，我的哥哥/姐姐/爸爸会叫我胖子，失败者，家里的害群之马，没有我，家里会过得更好。	触发性事件,触发性事件##生活
当我在学校的时候，我经常被欺负。	触发性事件,触发性事件##学习工作
我一生都是一个孤独的人，	认知歪曲,认知歪曲##以偏概全
我第一次对别人敞开心扉是我的第一个女朋友，我只认识她两个星期。我记得当她轻轻地抚摸我的头发时，我在她怀里嚎啕大哭。那是我一生中最欣慰的时刻。过了一段时间，她厌倦了和我分手，说我太让人头疼了。	触发性事件,触发性事件##情感
自从她和我分手那天起，我只有两个最好的朋友。他们最近和我断绝了关系，因为他们非常虔诚，他们能做的就是让我振作起来，告诉我要活在上帝里，我通常会点头同意。	触发性事件,触发性事件##社会关系
我每天都躺在床上，直到我必须去上班，然后当我下班的时候，我就睡到再次工作。	触发性事件,触发性事件##学习工作
我攻读学士学位已经四年了，我刚刚发现我这学期有三门课不及格，这意味着我的经济资助将被终止。	触发性事件,触发性事件##学习工作
以面对我的回避型人格障碍	触发性事件,触发性事件##疾病症状
我学了一个我不喜欢的专业，而且就业前景很糟糕，更糟糕的是我选了这个专业。我选择它是因为它几乎不需要数学，我的大脑不擅长处理数字，所以我的选择一开始就非常有限。我的一些同龄人在第一年之后就退学了，但我坚持了下来(通过了最低限度的学习，获得了C学位，对吧?)	触发性事件,触发性事件##学习工作
当我想到我的未来时，我心中充满了恐惧。	情绪反应,情绪反应##情感效应
试过很多次了。我想我今晚会成功的。也许如果我让人把我从悬崖边推到海里;付钱给他们，他们可能会帮我最终成功。	情绪反应,情绪反应##行为效应
我结婚快两年了，嫁给一个从不理解我感受的男人。	触发性事件,触发性事件##生活
我没有钱，没有朋友，什么都没有。	触发性事件,触发性事件##社会关系
我开始用割伤自己的方式让自己冷静下来。	情绪反应,情绪反应##行为效应
但今晚，我根本不想那么做。割伤只会给我留下伤痕，没有解决办法。	驳斥,驳斥##有效驳斥
了解我自己，我也知道我不能自杀。	驳斥,驳斥##有效驳斥
我真的在考虑让一个晚上独自游荡的人，一个看起来可能会这么做的人，拿走我口袋里的钱，然后推我一把。	情绪反应,情绪反应##行为效应
只想结束这一切。	情绪反应,情绪反应##行为效应
我已经到了上吊自杀的地步了。	情绪反应,情绪反应##行为效应
一切都是从我哥哥自杀开始的。这让我的整个生活支离破碎。	触发性事件,触发性事件##生活
唯一真正支持我的人是我的女朋友。我们的关系一直很好，直到我们分手，几天后和一个男人上床。	触发性事件,触发性事件##情感
我很伤心	情绪反应,情绪反应##情感效应
好几个月没说话了，太恶心和伤心了。	情绪反应,情绪反应##情感效应
从那以后我什么都没得到，	认知歪曲,认知歪曲##否定正面思考
我已经用威士忌和自我伤害自我治疗了4年了(现在22岁了)。	情绪反应,情绪反应##行为效应
我有他的旧折刀，我很想用他的刀刃来结束它。	情绪反应,情绪反应##行为效应
如果我既不能被爱也不能生儿育女，那我他妈的还活着干什么？	认知歪曲,认知歪曲##非此即彼
没有人陪伴，生命还有什么用。	认知歪曲,认知歪曲##否定正面思考
我是个失败者	认知歪曲,认知歪曲##乱贴标签
我死后谁会想念我？没有人。	驳斥,驳斥##习惯性驳斥
心理治疗一点用都没有，与人交谈一点用都没有	认知歪曲,认知歪曲##妄下结论
小学时自杀过两回。	情绪反应,情绪反应##行为效应
高中复课时自杀过三回	情绪反应,情绪反应##行为效应
然后很痛苦描述不出来的痛苦，	情绪反应,情绪反应##情感效应
计划在 29 岁时自杀。	情绪反应,情绪反应##行为效应
我的生活是 24/7 的重复学习，然后是钢琴 24/7 和秘密游戏 24/7（是的，我是亚洲人，确切地说是韩国人），24/7 游泳和阅读无聊的屁股经典书籍 24/7	触发性事件,触发性事件##生活
于是我想到了一个绝妙的主意，如果我不想变老，就自杀吧。	情绪反应,情绪反应##行为效应
我与死亡的距离不缺导火线，缺的只是一个稍微平和一点的死的方式，或许就是一瓶安眠药，	情绪反应,情绪反应##行为效应
一个朋友的死亡，一两次失恋，一次嘲讽，一次冤屈，一段被压迫的时光，一次被猥亵，	触发性事件,触发性事件##社会关系,触发性事件,触发性事件##生活
我不能接受世界上的很多事情，可是我最难接受的是我自己	认知歪曲,认知歪曲##否定正面思考
我有严重的自杀倾向和抑郁	触发性事件,触发性事件##疾病症状
我只想结束这一切。	情绪反应,情绪反应##行为效应
患有创伤后应激障碍、边缘性人格和严重的社交焦虑	触发性事件,触发性事件##疾病症状
这源于过去几个月与我所有朋友的退缩和烧毁桥梁。	触发性事件,触发性事件##社会关系
生活没有意义	认知歪曲,认知歪曲##妄下结论
这个世界是如此悲伤和沮丧	情绪反应,情绪反应##情感效应
我没有动力完成大学并工作一辈子。	触发性事件,触发性事件##学习工作
我一生的挚爱是和别人约会，	触发性事件,触发性事件##情感
我的愤怒和人格障碍毁了这段关系	情绪反应,情绪反应##情感效应
我没有朋友，我和我抑郁的妈妈和抑郁的弟弟住在家里。我不能再下床了，当我下床时，只能暴饮暴食，然后回到床上。	触发性事件,触发性事件##生活
我很想自杀，请帮忙。	情绪反应,情绪反应##行为效应
抑郁的生活毫无价值，	认知歪曲,认知歪曲##妄下结论
我没有真正的朋友也没有欣赏我的人。	触发性事件,触发性事件##社会关系
我的家庭有很多问题，身体上和精神上的虐待，酗酒，我的母亲患有某种神经症，因为他们在家里的所有压力。只要我意识到我自己和我的环境，我就会忍受那种环境，几个月前，这一切对我来说太难以忍受了，我搬走了。	触发性事件,触发性事件##生活
我非常孤独	情绪反应,情绪反应##情感效应
我看不出有什么理由待在这里。	认知歪曲,认知歪曲##否定正面思考
在我毁掉别人的生活之前自杀	情绪反应,情绪反应##行为效应
抑郁的生活毫无价值，	认知歪曲,认知歪曲##妄下结论
如果我有枪，事情就简单多了。我连自杀的方法都不知道。	情绪反应,情绪反应##行为效应
第二次在医院开的抑郁焦虑安眠，半个月的量我一次吃完了。	情绪反应,情绪反应##行为效应
在我父亲去世之前，我一直很想自杀，但一个月后，这些想法几乎没有进入我的脑海。但现在它们似乎是唯一占据我脑海的东西。	情绪反应,情绪反应##行为效应
自从我辞去工作和两个朋友一起创业以来，这一切都变得最明显了，但每天我觉得我们犯了一个巨大的错误，我们将失去一切。生意兴隆，但还没有起飞到足以支付我们的工资。每个月我都会处理数字，希望我们有足够的钱和信用来支付账单。我讨厌当老板，我希望我从来没有辞掉工作。	触发性事件,触发性事件##学习工作
如果有人给我一个按钮，说它会在24小时内杀死我在睡梦中，我会按下它并表示感谢。	情绪反应,情绪反应##行为效应
我想在淋浴时自杀，但我失败了。	情绪反应,情绪反应##行为效应
我再也找不到任何留在这个星球上的理由了。	认知歪曲,认知歪曲##否定正面思考
我一事无成。	认知歪曲,认知歪曲##妄下结论
我试着用剃刀割我的胳膊，但我只割了几处小伤口。	情绪反应,情绪反应##行为效应
我觉得我是社会的寄生虫，	认知歪曲,认知歪曲##乱贴标签
我什么都做不了。	认知歪曲,认知歪曲##妄下结论
我有自闭症，	触发性事件,触发性事件##疾病症状
一切对我来说都太多了，我不能经常旅行，我不能每周做超过1小时的志愿工作，我甚至不能像其他人一样接受教育，工作和男朋友。	触发性事件,触发性事件##生活
而我却成了一文不值的废物。	认知歪曲,认知歪曲##妄下结论
自杀似乎是个好办法。	情绪反应,情绪反应##行为效应
我们和8只狗住在一间只有一间卧室的拖车里，到处都是蟑螂。从来没有吃过东西。	触发性事件,触发性事件##生活
结果很失望	情绪反应,情绪反应##情感效应
嗑了很多药来麻痹自己	情绪反应,情绪反应##行为效应
我没有目标，也没有未来。	认知歪曲,认知歪曲##妄下结论
我决定服用过量的药(晕车药)。我拿了满满两瓶。	情绪反应,情绪反应##行为效应
把19年来对上帝的愤怒一次发泄出来	情绪反应,情绪反应##情感效应
我想结束我的生命	情绪反应,情绪反应##行为效应
但我很害怕	情绪反应,情绪反应##情感效应
受够了每时每刻的痛苦，受够了羞愧。厌倦了那种无能为力的感觉。	情绪反应,情绪反应##情感效应
我想结束这一切。	情绪反应,情绪反应##行为效应
不过我还是很害怕。	情绪反应,情绪反应##情感效应
我和妈妈相处不好，她为有我而感到羞耻。	触发性事件,触发性事件##生活
我受够了这一切，受够了感觉自己一无是处。受够了做狗屎。	认知歪曲,认知歪曲##放大和缩小
只想结束这一切。	情绪反应,情绪反应##行为效应
女朋友离开了我。	触发性事件,触发性事件##情感
到目前为止，我的生活并不是最好的，但我还过得去(尽管很挣扎)。	触发性事件,触发性事件##生活
我曾经有一个深爱我的女朋友，她离开了我，因为她不想要亲密的关系，显然我叫她的昵称，告诉她我爱她太过分了。	触发性事件,触发性事件##情感
我没有一个真正可以依靠的人，	认知歪曲,认知歪曲##否定正面思考
我一直有很多自杀的念头。	情绪反应,情绪反应##行为效应
而我在这段时间里找到的任何满足感都不值得经历这种黑暗。	认知歪曲,认知歪曲##心理过滤
我患有躁狂抑郁症，我不能相信自己的大脑，我的思想。	触发性事件,触发性事件##疾病症状
这是有史以来最糟糕的一次。	认知歪曲,认知歪曲##放大和缩小
我幻想杀了我和他。	情绪反应,情绪反应##行为效应
这种痛苦不值得。	认知歪曲,认知歪曲##妄下结论
我们可以从一切中解脱出来。	认知歪曲,认知歪曲##否定正面思考
今晚有自杀倾向。	情绪反应,情绪反应##行为效应
我想不出比这更糟糕的生活或出生的时间。	认知歪曲,认知歪曲##否定正面思考
这是一场可怕的噩梦	情绪反应,情绪反应##情感效应
我希望自杀能成为我的慰藉，	情绪反应,情绪反应##行为效应
我只是觉得再也没有理由活着了	认知歪曲,认知歪曲##否定正面思考
我根本看不到我的未来。	认知歪曲,认知歪曲##否定正面思考
不要醒来。	情绪反应,情绪反应##行为效应
没人要我。我是无用的。	认知歪曲,认知歪曲##妄下结论
我不配拥有生命，所以我要把这份礼物还回去。	情绪反应,情绪反应##行为效应
我是个同性恋	触发性事件,触发性事件##情感
没什么情感没有朋友只想一个人待着	触发性事件,触发性事件##生活
最长的一段时间有一个月没说过话靠微信和人交流	触发性事件,触发性事件##社会关系
晚上熬夜白天睡觉一天只吃一餐	触发性事件,触发性事件##生活
又是个懦夫割腕到一半嫌疼	情绪反应,情绪反应##行为效应
半夜自己流泪今天是年三十也许我应该在新年前结束	情绪反应,情绪反应##情感效应
新工作让我感到恐慌	触发性事件,触发性事件##社会关系
但我无法承受这种焦虑。	情绪反应,情绪反应##情感效应
由于新冠疫情，我负债累累(这个月无法交房租)，	触发性事件,触发性事件##生活
所以我不得不取消了我的学业，	触发性事件,触发性事件##学习工作
如果这行不通，那我就没戏了。	认知歪曲,认知歪曲##妄下结论
获得学士学位是我一直期待的事情，现在我不得不取消它，我失去了最后一点希望	认知歪曲,认知歪曲##以偏概全
每当我开始蓝领工作(这是我现在所在城市能找到的)，我就会严重恐慌。	触发性事件,触发性事件##学习工作
我准备好了一瓶酒，可以和药一起吞下。	情绪反应,情绪反应##行为效应
因为反正也没有人来看我。	认知歪曲,认知歪曲##情绪化推理
小学年少无知只因爸爸看我成绩一落千丈打电话给我最害怕的班主任。	触发性事件,触发性事件##学习工作
得知班主任会当众批评我，脸皮薄的我想一死了之。	情绪反应,情绪反应##行为效应
无法摆脱自杀念头	情绪反应,情绪反应##情感效应
我是一所好大学的好学生，有好朋友和好爱好。	触发性事件,触发性事件##社会关系
我似乎无法通过我的任何关系，我的任何成就感到满足。	认知歪曲,认知歪曲##情绪化推理
但我觉得我只想束缚我的责任，分配我的东西，然后迷路。	认知歪曲,认知歪曲##否定正面思考
今晚我想自杀。	情绪反应,情绪反应##情感效应
我有严重的癫痫，还有躁郁症。	触发性事件,触发性事件##疾病症状
我在未来几年内患精神分裂症的风险很高。	触发性事件,触发性事件##疾病症状
我没有社交生活，而且在很大程度上也没有真正的兴趣去发展社交生活。我和家人没有联系。	触发性事件,触发性事件##社会关系,触发性事件,触发性事件##生活
我只是找不到任何继续下去的理由。	认知歪曲,认知歪曲##情绪化推理,情绪反应,情绪反应##情感效应
心一横，纵身跳了下去……	情绪反应,情绪反应##行为效应
我患有抑郁症和焦虑症已经8年了	触发性事件,触发性事件##疾病症状
但我从来没有足够的关心去承诺。	情绪反应,情绪反应##情感效应
我也很有自我毁灭的倾向	情绪反应,情绪反应##情感效应
我做了一件让我最好的朋友男朋友不高兴的事。	触发性事件,触发性事件##情感
我的大学成绩不及格，可能不得不要求我明年休学	触发性事件,触发性事件##学习工作
我不知道还能做什么。	驳斥,驳斥##习惯性驳斥
我真的，真的很讨厌我的生活。	触发性事件,触发性事件##生活
我变得越来越绝望，我的心理健康状况越来越差，	情绪反应,情绪反应##情感效应
是个彻头彻尾的失败者。	认知歪曲,认知歪曲##乱贴标签
我男朋友都不能让我活下去了。	触发性事件,触发性事件##情感
我有恐慌症，因为我可能因为老师的虐待而患上了一种创伤后应激障碍。	触发性事件,触发性事件##疾病症状
我的前女友，我最爱和最关心的人，对我自杀已经完全麻木了。	触发性事件,触发性事件##情感
没有人真正关心。	驳斥,驳斥##习惯性驳斥
我觉得他们这样做只是因为他们对我在那里时没有和我说话感到内疚。	认知歪曲,认知歪曲##情绪化推理
我只是想平静地自杀，不用担心恐慌。	情绪反应,情绪反应##情感效应
我有一个自杀的计划，我有自杀的想法。	情绪反应,情绪反应##情感效应
我一生中的大部分时间都在与焦虑和抑郁作斗争。	触发性事件,触发性事件##疾病症状
我成长在一个低收入的移民家庭。在我很小的时候，我父母经常吵架，我父亲会在情感上虐待我和我母亲，我母亲有一段时间考虑过离婚，但我想他们还是为了我而在一起。	触发性事件,触发性事件##生活
那是我第一次陷入抑郁。	情绪反应,情绪反应##情感效应
我在中学的学习成绩仍然很好，但我因为聪明和内向而受到欺负。	触发性事件,触发性事件##社会关系,触发性事件,触发性事件##学习工作
我的自尊心很低，还出现了社交焦虑。	触发性事件,触发性事件##疾病症状
因为我交了一些朋友，不过我还是很内向，	触发性事件,触发性事件##社会关系
高中期间我主要关注的是取得好成绩。我在大学里也取得了好成绩	触发性事件,触发性事件##学习工作
焦虑和抑郁越来越严重。	情绪反应,情绪反应##情感效应
但我觉得自己很失败。	认知歪曲,认知歪曲##否定正面思考,认知歪曲,认知歪曲##情绪化推理
我的朋友很少，而且我从来没有交过女朋友。	触发性事件,触发性事件##情感
我最近在亚马逊上买了一根绳子和凳子，以防万一我再也受不了了，我想自杀。	情绪反应,情绪反应##行为效应
我不知道，我不知道的事太多了，管他呢，吃完这一顿，以后我什么都不用知道了。	驳斥,驳斥##习惯性驳斥
没有人能帮助我。	驳斥,驳斥##习惯性驳斥
我今年26岁，不得不搬回去和父母住。	触发性事件,触发性事件##生活
在我一再告诉他们我不能再这样做之后，他们就不理我，让我一个人呆一整天。	触发性事件,触发性事件##情感
我没有朋友。	触发性事件,触发性事件##社会关系
我无法忍受自己。	情绪反应,情绪反应##情感效应
我真的希望第三次世界大战真的发生了，我们都死了，这样我的家人就不用在我去世的时候伤心了。	认知歪曲,认知歪曲##情绪化推理
我每晚都祈祷自己不要醒来。	情绪反应,情绪反应##情感效应
我身体上和精神上都很痛苦，无法再忍受下去了。	认知歪曲,认知歪曲##情绪化推理
我真的很努力，但还是没用。	认知歪曲,认知歪曲##情绪化推理
我即将咽下最后一口气的日子快到了。	情绪反应,情绪反应##情感效应
我就一直有自杀倾向。	触发性事件,触发性事件##疾病症状
我意识到人类在这个世界上活得太久了。	认知歪曲,认知歪曲##情绪化推理
我发誓那永远不会是我。	驳斥,驳斥##习惯性驳斥
从那以后，我一直抱着50岁时心脏病发作的希望生活。我每天抽一包烟，我把这叫做拖延症自杀。我吃快餐就像它要倒闭了一样。我不胖，我只是很不健康。	触发性事件,触发性事件##生活
我把这个计划告诉了一个我认为可以信任的人。	触发性事件,触发性事件##情感
我被诊断为躁郁症	触发性事件,触发性事件##疾病症状
他们都希望我在他们的网络中去看不同的医生，这样我就能得到他们认为我需要的东西。	认知歪曲,认知歪曲##情绪化推理
他妈的混蛋。我只想一个人安静地死去。	情绪反应,情绪反应##情感效应
这整个磨难对我没有任何帮助，只是加快了我心中的进程。	驳斥,驳斥##习惯性驳斥
我准备好认输了。这种生活不值得。	驳斥,驳斥##习惯性驳斥
没有未来。我最好的选择是自杀	情绪反应,情绪反应##情感效应
我没有工作，没有钱，没有动力或主动性去改善我的生活。	触发性事件,触发性事件##学习工作,触发性事件,触发性事件##情感
上周我又服药过量了。	情绪反应,情绪反应##行为效应
已经嗑药过量十次了每次都有人发现我。	情绪反应,情绪反应##行为效应
我有一份工作，但因为在工作中嗑药而被解雇。	触发性事件,触发性事件##学习工作
我告诉他们我不在乎我是死是活。	情绪反应,情绪反应##情感效应
我前女友吸毒过量死了。	触发性事件,触发性事件##情感
我又试图自杀。我买了些乙酰胎儿药，故意过量服用。	情绪反应,情绪反应##行为效应
没人来看我，没人关心我，没人打电话，什么都没有。	触发性事件,触发性事件##社会关系
我的未来是暗淡的。	认知歪曲,认知歪曲##否定正面思考,认知歪曲,认知歪曲##情绪化推理
我没有想象力，我甚至无法乐观。	情绪反应,情绪反应##情感效应
出院后我无家可归好几个月因为我嗑药被赶出了家。	触发性事件,触发性事件##生活
我不怕死。至少我的痛苦结束了。	驳斥,驳斥##习惯性驳斥
我被临床诊断为重度抑郁症，广泛性焦虑症和躁郁症。	触发性事件,触发性事件##疾病症状
这是我给自己带来的又一层耻辱。	认知歪曲,认知歪曲##放大和缩小
我觉得自己不足、腐败、有缺陷。	认知歪曲,认知歪曲##乱贴标签
我想自杀。	情绪反应,情绪反应##情感效应
我是一个失败者，甚至可能不会成功地结束自己的生命。	认知歪曲,认知歪曲##情绪化推理
我让每个人都失望了。	认知歪曲,认知歪曲##以偏概全,认知歪曲,认知歪曲##情绪化推理
我没有朋友，因为吸食海洛因，我失去了所有的朋友。	触发性事件,触发性事件##社会关系
我的焦虑一直处于惊恐发作的水平。	触发性事件,触发性事件##疾病症状
我准备结束我的存在。	情绪反应,情绪反应##情感效应
我被诊断出患有重度抑郁症。	触发性事件,触发性事件##疾病症状
我知道我已经抑郁很多年了(现在快三年半了)。	触发性事件,触发性事件##疾病症状
那就是情况越来越糟，而且感觉恶化的速度并没有放慢。	触发性事件,触发性事件##疾病症状
我的分数从198分降到了150分，	触发性事件,触发性事件##学习工作
我开始吃得更健康	触发性事件,触发性事件##生活
我把专业换成了我更喜欢的、更有职业前景的专业，我转了大学	触发性事件,触发性事件##学习工作
我加入了一些俱乐部，交了一些朋友，我甚至在两年半没有被邀请参加任何活动后参加了我的第一个大学派对。	触发性事件,触发性事件##社会关系
如果有的话，它只会变得更糟，因为我甚至不希望任何更多的改变会有所帮助。	认知歪曲,认知歪曲##否定正面思考
我真希望我当时就死了，这样我就可以省去这么多痛苦，	认知歪曲,认知歪曲##情绪化推理
我真希望我当时就死了，这样我就可以省去这么多痛苦，我的父母也可以向前看，现在我有一大堆人要和我一起拖垮。	情绪反应,情绪反应##情感效应
我想我认为这是最新的事情，因为这是我唯一没有做出的改变之一，因为我真的很讨厌自己(在过去的几年里，我几乎从我的GPA中获得了任何自我价值，我真的不相信内在的自我价值)。	驳斥,驳斥##习惯性驳斥
还从来没有约会过，更别说接受非柏拉图式的拥抱了。	触发性事件,触发性事件##情感
没有人对我表现出兴趣，	认知歪曲,认知歪曲##情绪化推理
感觉这些年来我所做的一切改变都毫无意义。	驳斥,驳斥##习惯性驳斥
我一直都很孤独，很痛苦。	情绪反应,情绪反应##情感效应
我已经很多年没有哭过了，所以我只是在想哭的时候自残。	情绪反应,情绪反应##情感效应
这并不是最好的释放，而且感觉效果越来越差，因为最近它不能像以前那样给我带来快感了，它只是让呼吸变得更容易一些。	驳斥,驳斥##有效驳斥
感觉我在人生的道路上被落下了。	认知歪曲,认知歪曲##否定正面思考,认知歪曲,认知歪曲##情绪化推理
我什么都不喜欢了。	情绪反应,情绪反应##情感效应
我现在不喜欢跑步或徒步旅行了，而且每年的这个时候都太冷了。	触发性事件,触发性事件##生活
但我很糟糕，我是一个完美主义者，所以练习是如此令人沮丧，以至于我几乎无法做到这一点，也无法变得更好。	认知歪曲,认知歪曲##否定正面思考
我曾经想:“好吧，我就等到30岁，如果情况没有改善，我就自杀。”	情绪反应,情绪反应##情感效应
随着情况的恶化，我把这个数字提高到了25。最近，我把它推迟到毕业后(我在想它可以作为我给自己的毕业礼物)。	认知歪曲,认知歪曲##放大和缩小
我再也不相信"一切都会好起来"的说法了。	认知歪曲,认知歪曲##情绪化推理
当自杀的念头变得非常严重时，我得到的所有医疗建议都是分散自己的注意力。我不明白是为了什么?比如，如果我现在不自杀，然后呢?我明天还会继续受伤吗?这似乎导致的唯一结局是“当你可以继续伤害明天的时候，为什么现在要自杀呢?	驳斥,驳斥##习惯性驳斥
生活不值得。	认知歪曲,认知歪曲##妄下结论
除了我的猫，我找不到早上醒来的理由	触发性事件,触发性事件##生活
我有一个我爱的男朋友	触发性事件,触发性事件##情感
不是我想死，而是我不想再活下去了。	情绪反应,情绪反应##情感效应
在这一点上，我看到的唯一的选择是成为一个瘾君子来麻痹自己，或者只是死亡，	认知歪曲,认知歪曲##情绪化推理
我甚至不能开始学校的作业，	触发性事件,触发性事件##学习工作
因为焦虑，	触发性事件,触发性事件##疾病症状
生活似乎不值得为之努力。	认知歪曲,认知歪曲##妄下结论,认知歪曲,认知歪曲##情绪化推理
我的一生就是一件又一件可怕的事。	认知歪曲,认知歪曲##否定正面思考
我在一个非常糟糕的家庭中长大，有很多情感虐待。我全家都是瘾君子	触发性事件,触发性事件##生活
我有边缘性人格障碍，被称为“怪异、疯狂、粘人、神经病”等等	触发性事件,触发性事件##疾病症状
我刚搬到西澳，从来没有感觉这么可怜过。	触发性事件,触发性事件##生活
我是“有毒的”	认知歪曲,认知歪曲##乱贴标签
我内心的一部分不想死。	驳斥,驳斥##有效驳斥
我愿意相信一切都会好起来，	驳斥,驳斥##有效驳斥
我活着还有什么意义!	认知歪曲,认知歪曲##情绪化推理
不是沮丧或悲伤，而是一天比一天更适应自杀，因为我只是不喜欢活着的挣扎。	认知歪曲,认知歪曲##情绪化推理
我真的不知道我的生活在做什么。	认知歪曲,认知歪曲##心理过滤
是一名电影制作人，	触发性事件,触发性事件##学习工作
我没有真正的朋友，也没有家人，我生活中的每个人都像是我自己成功的资产，我忍不住，这很糟糕......	触发性事件,触发性事件##社会关系
我 16 岁时被赶出去，很快就无家可归了，从那时起，我似乎对生活本身变得麻木不仁	触发性事件,触发性事件##生活
，我慢慢变成了一个酒鬼。	触发性事件,触发性事件##生活
最近我一直在考虑买一把枪或做一个出口袋然后结束它，	情绪反应,情绪反应##情感效应
为什么我还要忍受40-50年的不确定性和挣扎，而我现在就可以结束它？ 	情绪反应,情绪反应##情感效应
我已经从我国最好的大学之一毕业了，我在大学入学考试中获得了奖学金和国家学位。	触发性事件,触发性事件##学习工作
我以3.2/4的gpa成绩毕业。	触发性事件,触发性事件##学习工作
在大学的前3年里我在一个很棒的乐队里演奏，和5-6个女人睡过，我和其中两个有过一段认真的关系，持续了2.5年。	触发性事件,触发性事件##社会关系
我已经毕业并获得了我想要的研究生院的录取，目前我正在学习游戏技术。	触发性事件,触发性事件##学习工作
今年2月14日，一切都改变了。我的女朋友为了一个混球把我耍了，我的父母离婚了(关于这个话题他们对我很刻薄)	触发性事件,触发性事件##生活
我不得不换工作，因为我觉得我的工资过低，在那里被利用了，现在我在国防工业工作(这和我想象的职业完全不同)。	触发性事件,触发性事件##学习工作
每当我回顾过去，我都会对自己说我可以做得更好。	认知歪曲,认知歪曲##否定正面思考
如果我住在另一个国家，我可以做得更好，如果我不把时间浪费在两段长期认真的关系上，我可以做得更好。我可以做得更好，如果我决定出国留学，只是接受我父母的提议支付它(我不想让他们支付我的教育)。如果我在瑞典参加eramus项目时没有女朋友，我可以做得更好。如果我不停止创作音乐或写诗和故事，我可以做得更好;如果我没有过早地接受国防工业的工作，因为辞职意味着被禁止进入土耳其收入最高的行业，我可以做得更好。	驳斥,驳斥##习惯性驳斥
我所做的一切对我来说都是失败的。	认知歪曲,认知歪曲##以偏概全
最糟糕的是，我的体重增加了很多，我的自尊在地上，我只是不再相信自己或者换句话说，我不再欺骗自己，我可以完成任何事情。	认知歪曲,认知歪曲##情绪化推理
我所做的一切都不能满足我，我感觉我正在慢慢失去我所有的技能(社交，艺术，一般等等)。	情绪反应,情绪反应##情感效应
我不会给我周围的人增加价值。没有人需要我，没有人渴望我的爱，需要我的支持，需要我在他们身边。	认知歪曲,认知歪曲##妄下结论
我不能像以前那样结识新朋友，让他们喜欢我。	认知歪曲,认知歪曲##以偏概全
我知道我意识到这些信念最终只会让我成为失败者，我无法改变它们，因为它们已经融入了我的思想。	认知歪曲,认知歪曲##妄下结论,认知歪曲,认知歪曲##情绪化推理
我觉得我被困在了这个地方，那里的人太糟糕了;	驳斥,驳斥##习惯性驳斥
我已经无法形容我现在的心情了，	情绪反应,情绪反应##情感效应
我对自己表达自己的方式没有信心	情绪反应,情绪反应##情感效应
这种生活太复杂，太苛刻，太肤浅，最重要的是，太没有价值，尤其是在土耳其。	认知歪曲,认知歪曲##以偏概全,认知歪曲,认知歪曲##情绪化推理
在土耳其之外，我就是个该死的蟑螂。	认知歪曲,认知歪曲##乱贴标签
我只想死，很自然，就在此刻，就在一瞬间。	情绪反应,情绪反应##情感效应
我以前抑郁过，甚至接受过一些药物治疗。	触发性事件,触发性事件##疾病症状
我们是一堆原子	认知歪曲,认知歪曲##乱贴标签
如果我死了，我不会在乎任何人和任何事。我不会因为我可以做很多事情，生孩子之类的事情而感到沮丧。	认知歪曲,认知歪曲##情绪化推理
几个月前，我被交往了3年的男友强奸了。	触发性事件,触发性事件##社会关系
几周前，我被诊断出患有创伤后应激障碍，并服用了抗焦虑药物。	触发性事件,触发性事件##疾病症状
因为我知道我内心正在酝酿着一些严重的问题，	触发性事件,触发性事件##情感
我很喜欢他。	触发性事件,触发性事件##情感
有几次我向朋友们求助，告诉他们我正在走下坡路，他们要么在最后一刻放弃，要么一直拖延。	触发性事件,触发性事件##社会关系
我觉得人力资源部把我的情况告诉了其他人。	认知歪曲,认知歪曲##放大和缩小
我觉得很孤独，很混乱。	情绪反应,情绪反应##情感效应
感觉像螺旋式下降到虚无是不可避免的	认知歪曲,认知歪曲##妄下结论
我想要痛苦。我想伤害我自己。	情绪反应,情绪反应##情感效应
我已经割伤了手腕(虽然没有造成太大的伤害)，喝了很多酒，吃了一些苯甲苯胺和苯类药物	情绪反应,情绪反应##行为效应
我想烧掉我的家，	情绪反应,情绪反应##情感效应
我想刺我自己	情绪反应,情绪反应##情感效应
我想要一个伤害别人的理由，让他们也伤害我。	认知歪曲,认知歪曲##情绪化推理
我在工作时表现得很开心，很外向，但回到家后，我不知道明天早上还能不能在这里。	情绪反应,情绪反应##情感效应
我害怕底部是死亡。	驳斥,驳斥##有效驳斥
我非常想回到巅峰，再次感到快乐	驳斥,驳斥##有效驳斥
但这似乎不可能。	认知歪曲,认知歪曲##妄下结论
明天我要开始为自杀做安排了。	情绪反应,情绪反应##行为效应
我的精神健康受到了第一次封锁的严重影响，我无法再进行一次封锁。	认知歪曲,认知歪曲##以偏概全
这主要是因为我被解雇了，不确定我是否或何时会回来。	触发性事件,触发性事件##学习工作
我在焦虑和恐惧中度过了将近两个月的时间。	触发性事件,触发性事件##情感
我只是一名临时工，不是一个不能被解雇的婴儿潮一代，有一份带薪的工作，享受在家工作的奢侈。	认知歪曲,认知歪曲##否定正面思考
这些年的努力应该得到更好的回报。	认知歪曲,认知歪曲##应该句式
明天我会买一些绳子，这样如果又一次封锁发生，我又失业了，我就可以上吊自杀了。	情绪反应,情绪反应##行为效应
我有自杀的念头。	情绪反应,情绪反应##情感效应
倾向于内化我的很多问题，通常不表达当我感到沮丧或悲伤。	触发性事件,触发性事件##情感
我觉得我的心态是不值得的，可悲的。	认知歪曲,认知歪曲##心理过滤
但是我没有遭受过任何大的悲剧，我的生活很轻松，与大多数人相比，轻松得可怜。	认知歪曲,认知歪曲##情绪化推理
我在零售和快餐店工作过。所以我经历过低级的入门级工作和上学，	触发性事件,触发性事件##学习工作
大部分时间都很糟糕。	触发性事件,触发性事件##情感
我一生中做的大多数事情我都后悔了	认知歪曲,认知歪曲##情绪化推理
我想我会死的。	情绪反应,情绪反应##情感效应
大多数人都没有，我怎么能超越到那种幸福的存在状态呢?它真的存在吗?我是在追求永远无法达到的东西吗?	认知歪曲,认知歪曲##心理过滤
因为我觉得我比大多数人弱，和大多数人相比我很可怜。	认知歪曲,认知歪曲##否定正面思考
我害怕有一天，当我最终面对我的深刻痛苦的时刻，它会给我结束生命的意志力。	认知歪曲,认知歪曲##情绪化推理
我今天要结束我的生命，	情绪反应,情绪反应##情感效应
我因创伤后应激障碍和类风湿性关节炎而残疾。	触发性事件,触发性事件##疾病症状
我厌倦了单身和被拒绝	触发性事件,触发性事件##情感
感觉自己好像是某种怪物	认知歪曲,认知歪曲##乱贴标签
我厌倦了没有人可以联系，也没有联系，没有陪伴	触发性事件,触发性事件##生活
我厌倦了在这个世界上孤独和单身，都是因为我的体重。这种孤独占据了我太多，它从内到外吞噬了我。	认知歪曲,认知歪曲##以偏概全
这种孤独占据了我太多，它从内到外吞噬了我。	认知歪曲,认知歪曲##情绪化推理
我到处看到的只有对我的仇恨。	认知歪曲,认知歪曲##非此即彼
我这辈子绝对没有人。而这种寂寞每天都在提醒我。	认知歪曲,认知歪曲##妄下结论
我已经结束了这个世界，今天结束了我的生命，所以再见大家，当有人读到这篇文章时，我就死了。	情绪反应,情绪反应##情感效应
我是时候离开了。	情绪反应,情绪反应##情感效应
本就是毫无意义的人生，坚持下去有意义吗，生命的存在，本就是无意义的，一个人如果不热爱生命，不如让他早早失去。	认知歪曲,认知歪曲##妄下结论
一个人如果不热爱生命，不如让他早早失去。	认知歪曲,认知歪曲##情绪化推理
因为对于不热爱它的人来说，拥有它是一种痛苦。	认知歪曲,认知歪曲##妄下结论
最近我比我这辈子都更想自杀。	情绪反应,情绪反应##情感效应
最近我又开始自残了	情绪反应,情绪反应##行为效应
我是一个20岁的变性人，和他19岁的男朋友和他妈妈住在一起。	触发性事件,触发性事件##社会关系
我不能一个人待着。每次我独自一人的时候，我就开始想要自残。	情绪反应,情绪反应##情感效应
我的抑郁症已经到了我很难照顾自己的地步。	触发性事件,触发性事件##疾病症状
我真的很害怕我会在工作中变得很不稳定。我几个星期前才开始工作，到目前为止我真的很喜欢这份工作	触发性事件,触发性事件##学习工作
我想保留它，但我害怕我的抑郁，尤其是我的焦虑会阻碍我进入。	触发性事件,触发性事件##情感
当我进去的时候，我的焦虑会突然爆发。	情绪反应,情绪反应##情感效应
就像我说的，我男朋友是来帮我照顾自己的。但这对他不公平。我是他的男朋友，不是他的孩子。他愿意照顾我，但他也有自己的生活。	驳斥,驳斥##习惯性驳斥
这他妈的把我吓坏了，因为如果我在那里的时候性别错了，我就不会变得更好了。	认知歪曲,认知歪曲##非此即彼,认知歪曲,认知歪曲##情绪化推理
我真的，真的不想从任何人那里借钱，我害怕我会负债，或者因为我付不起钱而被拒绝。	认知歪曲,认知歪曲##妄下结论
我害怕那里的其他人，因为我真的不想和其他精神病患者在一起。	情绪反应,情绪反应##情感效应
我有很严重的社交焦虑症，我讨厌和那些不是专业人士的人交谈。	触发性事件,触发性事件##疾病症状
我讨厌和那些不是专业人士的人交谈。	触发性事件,触发性事件##情感
我想自杀，我在自残。	情绪反应,情绪反应##情感效应
我在自残。	情绪反应,情绪反应##行为效应
我其实并不想死，但我害怕我会死。我得想想该不该去医院因为我就是不相信自己。	驳斥,驳斥##有效驳斥
构思着今晚用绞索自杀。或者也在尝试。或者试着把皮带系在淋浴栏杆上。	情绪反应,情绪反应##行为效应
但我确实把头伸了进去，让它呛了我一下	情绪反应,情绪反应##行为效应
我太在乎别人了，我很依恋他们，	触发性事件,触发性事件##情感
现在，她不想和我有任何关系，我知道这基本上是因为我发了一条过于激烈的短信，说我还想保持友谊。	触发性事件,触发性事件##社会关系
我知道这基本上是因为我发了一条过于激烈的短信	认知歪曲,认知歪曲##妄下结论
我真的觉得我们在调情，我觉得自己很愚蠢	认知歪曲,认知歪曲##乱贴标签
当这种情况发生时，我觉得它抹掉了他们对我的所有正面看法，因为一个错误，我就会失去所有这些，所以不管他们觉得我有多有趣，不管她觉得我有多体贴，最后我都毁了这一切。	认知歪曲,认知歪曲##以偏概全,认知歪曲,认知歪曲##否定正面思考
我觉得我没有什么可以提供的，因为积极的特质是不够的，我觉得我不够好，我一定有什么根本的问题。	认知歪曲,认知歪曲##否定正面思考
我觉得我对男人来说太敏感了，因此我没有吸引力，也没有什么可以提供的	认知歪曲,认知歪曲##情绪化推理
因此我没有吸引力，也没有什么可以提供的	认知歪曲,认知歪曲##妄下结论
而且由于我的敏感，我永远不会有一段长期的关系或亲密的友谊。	认知歪曲,认知歪曲##妄下结论,认知歪曲,认知歪曲##情绪化推理
我现在真的受够了。我31岁了，但我觉得我已经挣扎了很长时间。	情绪反应,情绪反应##情感效应
我不喜欢活着，我只想死。	情绪反应,情绪反应##情感效应
生活是如此的毫无意义，甚至不再有趣。	认知歪曲,认知歪曲##妄下结论
我满脑子想的都是我是多么的孤独，我实际上是多么的一坨屎	认知歪曲,认知歪曲##乱贴标签
千载难逢的日子里，我真的很开心，但我知道，这意味着第二天，或者第三天，我又会觉得自己很糟糕。	认知歪曲,认知歪曲##心理过滤
我又没有朋友可以一起玩。	触发性事件,触发性事件##社会关系
我给一些人发短信，但我很确定他们不会真的在意我是否停止回复。	认知歪曲,认知歪曲##妄下结论
没有什么值得活着的了。	认知歪曲,认知歪曲##以偏概全,认知歪曲,认知歪曲##情绪化推理
唯一阻止我自杀的是我父母会听到我自杀的消息。	驳斥,驳斥##有效驳斥
我只希望我能一言不发地离开，	情绪反应,情绪反应##情感效应
我的生活已经变成了一场等待的游戏，直到我长大到可以自杀而不会对我的父母产生太大的影响，或者直到他们都死了或者认不出我。	认知歪曲,认知歪曲##情绪化推理
我现在似乎找不到我要活下去的理由了。	认知歪曲,认知歪曲##情绪化推理
我不想创建家庭，我不与人攀比，我不追求物质，除了水电和三餐等没有其余花销	触发性事件,触发性事件##生活
没欲望，没追求，没理想，没动力。	触发性事件,触发性事件##情感
所谓的改变都是我自欺欺人，自我欺骗。	认知歪曲,认知歪曲##妄下结论
。6年前决定父母死后自杀，3年前决定30岁自杀，半年前决定3年内自杀，半个月前又觉得3年也太久了，2年吧，现在又想在1年半内结束死亡离我越来越近了，每天它都会在我耳边催促我一下让我快一点解脱。	情绪反应,情绪反应##情感效应
死亡离我越来越近了，每天它都会在我耳边催促我一下让我快一点解脱。	认知歪曲,认知歪曲##妄下结论
人不过一个过程，我只想提前结束这个过程，提前回归虚无。	认知歪曲,认知歪曲##妄下结论
我根本不适合这个世界。	认知歪曲,认知歪曲##情绪化推理
每当我为自己做好事时，我都会感到非常厌恶	触发性事件,触发性事件##情感
在我就读的大学里，人们真诚地关心我，我感到了一种我一生中从未体验过的幸福感。	触发性事件,触发性事件##社会关系,触发性事件,触发性事件##情感
我的奶奶是我见过的最有爱心和关心的人，她是我最亲密的朋友。我爷爷总是给我最好的建议和支持。	触发性事件,触发性事件##社会关系
那是我一生中压力最大的一段时间。	情绪反应,情绪反应##情感效应
在那一刻，我再也受不了了。	情绪反应,情绪反应##情感效应
我不够坚强，照顾不了爷爷，我辜负了他。我辜负了我奶奶，因为我没有给她需要的那种支持。	认知歪曲,认知歪曲##情绪化推理
因为我的过错，我不配拥有活着的权利。	认知歪曲,认知歪曲##以偏概全,认知歪曲,认知歪曲##放大和缩小
自从他去世后，我就麻木了，完全不知道该怎么办。	情绪反应,情绪反应##情感效应
唇疱疹并没有那么糟糕，但它足以把我推到边缘。	触发性事件,触发性事件##疾病症状,触发性事件,触发性事件##情感
所以，我肯定只有一个，大约一两个月后我可能还有一两个，但他们没有明显的症状。	认知歪曲,认知歪曲##妄下结论
结合这个事实，我认为80%的人口已经拥有它，并且在没有症状时给予它是非常罕见的。	认知歪曲,认知歪曲##情绪化推理
我已经对我的工作很痛苦了（我已经找了三个月的新工作了——我所在城市的经济很糟糕）	触发性事件,触发性事件##学习工作,情绪反应,情绪反应##情感效应
我的朋友群正在瓦解（主要是人们搬走或谈恋爱，忘记了他们的单身朋友）	触发性事件,触发性事件##社会关系
我和我的家人并不亲近。	触发性事件,触发性事件##社会关系
因为我是一个恶心的男人，可能会给你唇疱疹。	认知歪曲,认知歪曲##乱贴标签
我有很多爱好，我保持身材，我（我想现在是以前）在女人身上很成功，我有很多朋友。	触发性事件,触发性事件##生活
在六个月的时间里，我失去了三个最亲密的朋友（一个搬家了，一个现在恨我，另一个认为他的女朋友是生活中最重要的）	触发性事件,触发性事件##生活
从职业上讲，我无处可去，可能会在五月份被解雇，而且，根据我所在城市的就业市场，我找不到工作。	认知歪曲,认知歪曲##妄下结论
我即将成为一个失业和孤独的人。	认知歪曲,认知歪曲##乱贴标签
我想这可能就是恶性循环的全部	认知歪曲,认知歪曲##以偏概全,认知歪曲,认知歪曲##妄下结论
我从来都不是一个有动力的人。我一直是一个回避变化、安于现状的人。	认知歪曲,认知歪曲##以偏概全,认知歪曲,认知歪曲##妄下结论
选择去哪所大学，几乎没有什么研究，我选择了一个专业，只是因为我必须这样做	触发性事件,触发性事件##学习工作
我几乎没有职业道德，	认知歪曲,认知歪曲##否定正面思考
凭借我通过过度沉迷于有限的消遣而获得的GPA，摆在我面前的未来看起来黯淡而严峻	触发性事件,触发性事件##学习工作
摆在我面前的未来看起来黯淡而严峻	认知歪曲,认知歪曲##心理过滤,认知歪曲,认知歪曲##否定正面思考
我将在一家声誉良好的公司找到一份中等收入的工作，拥有一个冗长而听起来像企业的头衔，这对我的自尊心没有什么帮助，因为在现实中，我将在接下来的30年里把我的时间、激情和理智奉献给一栋混凝土建筑和一个坐在桌子后面的胖子。	认知歪曲,认知歪曲##心理过滤
我身边总是围绕着一群人，他们的平均水平是我的额外优势，他们被自己所做的事情所驱使和鼓舞，他们面前有一条既定的道路，他们尽自己所能推动自己前进	触发性事件,触发性事件##社会关系
平庸	认知歪曲,认知歪曲##乱贴标签
心情不好	触发性事件,触发性事件##情感
最近我无意中伤害了他们中的一个	触发性事件,触发性事件##社会关系
内疚	触发性事件,触发性事件##情感
焦虑和抑郁	触发性事件,触发性事件##疾病症状
我不喜欢治疗，但我真的应该重新开始	驳斥,驳斥##有效驳斥
自残	情绪反应,情绪反应##行为效应
，今晚我割伤了自己，手臂上有3个小伤口	情绪反应,情绪反应##行为效应
想过自杀	情绪反应,情绪反应##行为效应
但只是想过，因为我知道，几十楼跳下来脑浆糊一地有些难看，跳湖里会水肿，很丑，而且现在的城市哪有干净的湖水，悬梁的话，堵着一口气太难受了	驳斥,驳斥##习惯性驳斥
我一无是处	认知歪曲,认知歪曲##乱贴标签
我的记忆力糟透了	触发性事件,触发性事件##疾病症状
错过了截止日期	触发性事件,触发性事件##学习工作
我连最基本的数学概念都搞不懂	触发性事件,触发性事件##学习工作
没有朋友	触发性事件,触发性事件##社会关系
我没有时间去俱乐部。	触发性事件,触发性事件##社会关系
因为我真的没有其他选择	认知歪曲,认知歪曲##心理过滤
我在一家糟糕的商店做一份糟糕的兼职，周五晚上和周末的时间都被它占据了	触发性事件,触发性事件##生活
前的老板很棒，但他被一个混蛋取代了。	触发性事件,触发性事件##学习工作
我觉得我的很多同事都觉得我很蠢	触发性事件,触发性事件##社会关系
现在我觉得自己很丑	认知歪曲,认知歪曲##乱贴标签
我穿什么都不好看	认知歪曲,认知歪曲##妄下结论
从来没有一个人对我产生过浪漫的兴趣。我真的不认为会有人爱我。	认知歪曲,认知歪曲##妄下结论,认知歪曲,认知歪曲##情绪化推理
我想伤害自己	情绪反应,情绪反应##行为效应
但我太软弱，承受不了任何痛苦。我他妈又蠢又弱。	认知歪曲,认知歪曲##乱贴标签
很严重的焦虑和情绪波动	触发性事件,触发性事件##疾病症状
前段时间，上学校阳台很想跳下去。	情绪反应,情绪反应##情感效应
之前从来没想过死，主要原因很没出息的是因为原来喜欢自己的人讨厌了自己，否定自己。	触发性事件,触发性事件##情感
之前从来没想过死，主要原因很没出息的是因为原来喜欢自己的人讨厌了自己，否定自己。日	认知歪曲,认知歪曲##以偏概全
日日夜夜想念也见不到，平时压力很大，家里的关系也乱七八糟，虽然有爱我的爸爸。	触发性事件,触发性事件##社会关系,触发性事件,触发性事件##学习工作
秋天天台真的挺凉，但我最难受的时候也没跳下去，所以我既然苟活下来那就好好活下去。	驳斥,驳斥##有效驳斥
我失去了我的伴侣	触发性事件,触发性事件##生活
我有一个患有边缘型人格障碍的母亲	触发性事件,触发性事件##社会关系
我们所有的计划都泡汤了	认知歪曲,认知歪曲##放大和缩小
我对新家和新城市生活的信心破灭了。	认知歪曲,认知歪曲##非此即彼
我不会告诉任何我认识的人我要慢慢结束生命的计划	情绪反应,情绪反应##情感效应
永远都不够好	认知歪曲,认知歪曲##罪责归己/他
我活下去的理由离我而去。我不想继续了	情绪反应,情绪反应##情感效应
从我记事起，我的生活就很悲惨	触发性事件,触发性事件##生活
但我太生气了，无法成为一个好哥哥	认知歪曲,认知歪曲##罪责归己/他
我都充满了悲伤、愤怒和憎恨，憎恨自己	认知歪曲,认知歪曲##罪责归己/他
我在高中的时候经常割伤自己	情绪反应,情绪反应##行为效应
因为我讨厌自己，伤害自己是对的	认知歪曲,认知歪曲##情绪化推理
我遇见她之后，所有这些感觉都消失了。她不是我爱的第一个人，但她是第一个真正爱我的人，	触发性事件,触发性事件##情感
她是我生命中唯一让我想活下去的东西	认知歪曲,认知歪曲##非此即彼
我恨自己失去了一个对我好的人。我恨自己不是她想要的样子	认知歪曲,认知歪曲##罪责归己/他
我想死，这样我就不用再痛苦了，这样我就不用失去她了	认知歪曲,认知歪曲##情绪化推理
今年5月，我的弟弟去世了，享年17岁	触发性事件,触发性事件##社会关系
我的爱人是那个带走我痛苦的人，没有她我无法承受。	认知歪曲,认知歪曲##否定正面思考
我失去了一切，没有任何盼头	认知歪曲,认知歪曲##放大和缩小
上个月，交往了3年半的女朋友和我分手了	触发性事件,触发性事件##情感
她是我的一切	认知歪曲,认知歪曲##放大和缩小
我相信在某个时候我会找到一个“更好”的人，但我只想要她。	认知歪曲,认知歪曲##非此即彼
但生活中每一件“顺利”的事情都让我越来越觉得自己像个狗屎	认知歪曲,认知歪曲##乱贴标签
但生活中每一件“顺利”的事情都让我越来越觉得自己像个狗屎。	认知歪曲,认知歪曲##否定正面思考
和班上的人正常交谈，但这越来越难了	触发性事件,触发性事件##社会关系
我只想和奥德丽谈谈	认知歪曲,认知歪曲##心理过滤
计划明天从她和我喜欢去的悬崖上跳下去	情绪反应,情绪反应##情感效应
我已经挣扎了多年，我很害怕	触发性事件,触发性事件##情感
自杀、恐惧、焦虑的想法是如此接近我的脑海	情绪反应,情绪反应##情感效应
每天都对她和我一生中做过的所有事情感到绝望、失落、内疚和懊悔，	认知歪曲,认知歪曲##否定正面思考
我在治疗时复发并患上了严重的失眠症	触发性事件,触发性事件##疾病症状
我几乎每天晚上都会问自己这些，几乎每次都崩溃。	触发性事件,触发性事件##情感
我这辈子大部分时间都抑郁焦虑	触发性事件,触发性事件##疾病症状
我父母没帮我。	触发性事件,触发性事件##社会关系,触发性事件,触发性事件##情感
经历了一段很长时间的自杀倾向(我说的是他妈的几年)	情绪反应,情绪反应##情感效应
每样东西都能让我自杀。电线是套索。可以把吹风机扔进我的浴缸	情绪反应,情绪反应##情感效应
那种想要杀死自己的感觉太强烈了	情绪反应,情绪反应##情感效应
抑郁和长期的身体疼痛	触发性事件,触发性事件##疾病症状
他们甚至不愿意花一天时间和我在一起	触发性事件,触发性事件##情感
我的存在在任何方面都是可悲的	认知歪曲,认知歪曲##以偏概全
我的存在在任何方面都是可悲的。	认知歪曲,认知歪曲##妄下结论
因为一想到和我的前女友竞争，我就会恐慌	触发性事件,触发性事件##情感
，我丑陋的黑屁股太没有吸引力了	认知歪曲,认知歪曲##心理过滤
我爸说我检查治疗花了这么多钱怎么还没好	触发性事件,触发性事件##生活
对婚姻生活更是反感，活在这个世界连蝼蚁都不如，	认知歪曲,认知歪曲##放大和缩小
等我还完钱，我也应该就不在这个世界了。	情绪反应,情绪反应##情感效应
我刚写完遗书，马上就要结束我的生命了	情绪反应,情绪反应##情感效应
反正没人会在乎	认知歪曲,认知歪曲##心理过滤
我妈妈也不关心	触发性事件,触发性事件##情感
我在街上流浪了十年，目睹了许多自然死亡、谋杀或自杀就在我面前	触发性事件,触发性事件##生活
在过去的八年里，我一直在努力，但没有一次约会，更不用说一个给我机会的女人了。也许她是对的	认知歪曲,认知歪曲##否定正面思考
我要结束这一切	情绪反应,情绪反应##情感效应
我为我给每个人造成的痛苦和折磨感到抱歉	认知歪曲,认知歪曲##罪责归己/他
我想周五我可能会自杀	情绪反应,情绪反应##情感效应
我有点难过	触发性事件,触发性事件##情感
我的成绩很糟糕	触发性事件,触发性事件##学习工作
我只是无法面对可能是第26次让人如此失望	认知歪曲,认知歪曲##罪责归己/他
我想到的任何东西都毫无意义，比如一个新的电子游戏、漫画章节或电视剧。	认知歪曲,认知歪曲##妄下结论
最后，再忍受两天的痛苦，我就可以永远离开了	情绪反应,情绪反应##情感效应
我一辈子都要忍受痛苦	认知歪曲,认知歪曲##心理过滤
做一个毫无价值，没有天赋的孤独的狗屎	认知歪曲,认知歪曲##乱贴标签
从5岁起就抑郁了，而且很明显这种情况不会好转，所以是时候让我像个男人一样去做了	认知歪曲,认知歪曲##情绪化推理
我还太年轻，不应该抱怨什么	认知歪曲,认知歪曲##应该句式
我有女朋友，至少我觉得她还想和我在一起，但也许是我的想法控制了她。她不喜欢我的自杀想法，这对她造成了伤害	触发性事件,触发性事件##社会关系
我的学校生活正在崩溃	触发性事件,触发性事件##情感
我想我要失去这个女孩了整整两年我都没忘记她，但我把她找回来了。	触发性事件,触发性事件##情感
我希望今晚我就死。只是想和大家分享一下	情绪反应,情绪反应##情感效应
我每门课都不及格	触发性事件,触发性事件##学习工作
没有什么能让我开心	认知歪曲,认知歪曲##否定正面思考
我所有的选择都是自杀	情绪反应,情绪反应##情感效应
我想我应该从头开始	认知歪曲,认知歪曲##应该句式
我毕业。又一个该死的标记	认知歪曲,认知歪曲##否定正面思考
刚毕业，没有工作经验。我是失败的	认知歪曲,认知歪曲##乱贴标签
我的身体已经碎了。我已经是个失败者了	认知歪曲,认知歪曲##乱贴标签
我只是受够了一直做一个混蛋，一个负担，一个失望，一个失败者，一个毫无价值的神经病，	认知歪曲,认知歪曲##乱贴标签
我最近抛弃了我的梦中情人，我曾经爱过(现在仍然爱着)她胜过这世界上的一切	触发性事件,触发性事件##情感
我真的在考虑等我喝完药再自杀。	情绪反应,情绪反应##情感效应
最终成为他们的负担	认知歪曲,认知歪曲##罪责归己/他
过去也曾尝试过两次	情绪反应,情绪反应##行为效应
我很痛苦，经历了多年的情感创伤和童年时的性侵犯。	触发性事件,触发性事件##学习工作
我14岁时被她现在的丈夫强奸了	触发性事件,触发性事件##学习工作
那些记忆一直折磨着我，我的脑袋一直告诉我，最好的办法就是自杀	认知歪曲,认知歪曲##否定正面思考
我没事，我很安全	驳斥,驳斥##有效驳斥
虽然这对我严重的抑郁症有帮助，但并不能阻止这些侵入性的想法	驳斥,驳斥##习惯性驳斥
我这辈子找不到一个可以倾诉的信任的人，	认知歪曲,认知歪曲##否定正面思考
我的不及格次数比通过次数要多	触发性事件,触发性事件##学习工作
当我陷入黑暗时，她会陪在我身边吗?不，当然不是，	驳斥,驳斥##习惯性驳斥
我不在乎了，我所做的一切都毫无意义。	认知歪曲,认知歪曲##情绪化推理
我只想结束我的生命不值得再忍受一切都是徒劳	情绪反应,情绪反应##情感效应
今年25岁有一个很幸福的家庭父母很相爱很爱我老公对我也很疼爱	触发性事件,触发性事件##情感
每次和老公吵架我想到的只有死	认知歪曲,认知歪曲##否定正面思考
吵了无数次想过无数次死	情绪反应,情绪反应##情感效应
我接受不了他多我任何的忽视和不尊重	认知歪曲,认知歪曲##心理过滤
我曾经试图跳楼跳河身体都已经悬空一半了	情绪反应,情绪反应##行为效应
我只想做个正常人，生孩子，但我永远也做不到。	驳斥,驳斥##习惯性驳斥
我在20岁出头的时候被诊断出患有边缘型人格障碍。	触发性事件,触发性事件##疾病症状
Bpd以不同的方式影响人们。	触发性事件,触发性事件##疾病症状
对我来说这是件大事。	认知歪曲,认知歪曲##放大和缩小
我需要被爱和被需要，否则活着就没有意义了。	认知歪曲,认知歪曲##非此即彼
我觉得自己是妻子和家人的沉重负担。	认知歪曲,认知歪曲##情绪化推理
我没有像我哥哥姐姐那样在生活中取得成功，对此我深感羞愧。	认知歪曲,认知歪曲##情绪化推理
我努力工作，但我似乎从来没有得到任何东西，因为我一有机会就自我破坏，因为我拒绝让自己快乐。	驳斥,驳斥##习惯性驳斥
我打算在圣诞节前自杀。	情绪反应,情绪反应##行为效应
我太恨自己了，我无法控制自己。	触发性事件,触发性事件##疾病症状
我只想死得非常痛苦，这样我就可以为我在这个世界上造成的不和谐而受到惩罚。	认知歪曲,认知歪曲##罪责归己/他
我似乎只能记住发生在我身上的不好的事情	认知歪曲,认知歪曲##否定正面思考
人们似乎总是利用然后抛弃我。	认知歪曲,认知歪曲##妄下结论
我母亲在我17岁的时候去世了，我从来没有忘记这件事。	触发性事件,触发性事件##生活
我不想继续生活在痛苦中。	驳斥,驳斥##有效驳斥
我之所以还在这里，是因为尽管我觉得我毁了我妻子的生活，但她是我还在这里的原	认知歪曲,认知歪曲##以偏概全
午休时，我站在高速公路立交桥上，努力鼓起勇气跳下去，但我太害怕了，我想我知道从高处跳下去是不够的。	情绪反应,情绪反应##行为效应
没有人在乎。	驳斥,驳斥##习惯性驳斥
当他们所做的一切都是拒绝我，把我推开时，我无法感受到或理解他们是如何关心我的。	认知歪曲,认知歪曲##情绪化推理
我通常生活在很大的压力下。	触发性事件,触发性事件##生活
我做两份工作，一周工作六天，我还在大学兼职。	触发性事件,触发性事件##学习工作
去年，我的四个好朋友在我非常沮丧和自残的时候突然离开了我。	触发性事件,触发性事件##生活
去年12月我差点自杀	情绪反应,情绪反应##行为效应
我已经有很严重的社交焦虑症，不敢离开我的公寓，我已经很害怕在校园里遇到她，但现在我甚至在自己家里都没有安全感。	触发性事件,触发性事件##疾病症状
我是说，身体上是安全的，但情感上就不安全了。	触发性事件,触发性事件##疾病症状
看来我应该完成我在12月份开始计划的事情，然后自杀。	情绪反应,情绪反应##行为效应
我在想，看在我妈妈的份上，在我奶奶快要去世的时候自杀是不是更好这样她就能同时哀悼她的母亲和女儿了?	认知歪曲,认知歪曲##妄下结论
还有其他事情让我感觉很糟糕，但这些都是大事。	认知歪曲,认知歪曲##放大和缩小,认知歪曲,认知歪曲##情绪化推理
我不能这样生活。	驳斥,驳斥##习惯性驳斥
对我来说自杀真的是一种随时会冒出来的念头，有时候走在路上会想着给自己来一刀那种，很疲惫，因为自己要一直在正常的生活之外去压制这些念头。	触发性事件,触发性事件##疾病症状,情绪反应,情绪反应##行为效应
事情真的很糟糕。	认知歪曲,认知歪曲##妄下结论
事情只会变得更糟。	认知歪曲,认知歪曲##妄下结论
事情不太好。	驳斥,驳斥##习惯性驳斥
我什么都没了。	驳斥,驳斥##习惯性驳斥
我的大学研究生考试不及格	触发性事件,触发性事件##学习工作
我只是在书桌前一坐就是几个小时，书就放在我面前。想从我的窗户跳下去。	情绪反应,情绪反应##行为效应
因为我的研究生考试不及格，我知道我现在的工作没有前途，我甚至失去了搬家的动力。	认知歪曲,认知歪曲##放大和缩小
我在工作上遇到了大麻烦，精神崩溃，在精神病院呆了一段时间	触发性事件,触发性事件##疾病症状
我在工作上遇到了大麻烦，精神崩溃，在精神病院呆了一段时间。	触发性事件,触发性事件##学习工作
我看不出自己能做什么。	驳斥,驳斥##习惯性驳斥
生活是灰色的。	认知歪曲,认知歪曲##非此即彼
但随着年龄的增长，我开始意识到生活是完全没有意义的。	驳斥,驳斥##习惯性驳斥
我甚至不想活下去。	驳斥,驳斥##习惯性驳斥
我保持着非常积极的生活方式，吃得很好。	触发性事件,触发性事件##生活
我喜欢说唱、运动和鱼叉钓鱼。	触发性事件,触发性事件##生活
我太穷了，我甚至不知道我的音乐该如何发展。	认知歪曲,认知歪曲##放大和缩小
金钱是人类眼中唯一真正有价值的东西。	认知歪曲,认知歪曲##妄下结论
生活并不好玩	驳斥,驳斥##习惯性驳斥
我21岁，我在一旁看着我的同龄人结婚，上学，搬出去，享受他们毫无意义的生活。	触发性事件,触发性事件##生活
我只是顺从于我生活的小角落，独自一人，在这空虚中没有立足之地。	驳斥,驳斥##习惯性驳斥
我看着他们，心里知道我永远赶不上他们。	认知歪曲,认知歪曲##妄下结论
我他妈永远不会。	驳斥,驳斥##习惯性驳斥
我没有野心	驳斥,驳斥##习惯性驳斥
我正式选择退出，这个周期比我经历的上一个周期更糟糕、更激烈。	认知歪曲,认知歪曲##妄下结论
我厌倦了重复自己，就像我被困在一个循环中犯同样的错误，在我建立桥梁的时候烧掉自己的桥梁，躺在那里，因为我觉得没有什么比这更好的事情可做。	认知歪曲,认知歪曲##情绪化推理
我曾经想过，如果我要自杀，那么我一定会提前安排得妥妥当当的，放哪个墓地，通过什么方式被发现，房间也一定要收拾好，手机里该清理的东西清理好，反正要走得体体面面的，不要意气用事，太狼狈。	情绪反应,情绪反应##行为效应
我是大一新生，我和交往了九个月的女朋友分手了，但我从四年级就知道了	触发性事件,触发性事件##情感
那是三周前的事了，从那以后我觉得自己一无是处	认知歪曲,认知歪曲##乱贴标签
她不会再给我第二次机会了，我很确定她已经向前看了，不再爱我了。	认知歪曲,认知歪曲##妄下结论
我们吵过一次架。不是吵架，也不是争吵，我只知道她就是我的真命天子。	触发性事件,触发性事件##情感,认知歪曲,认知歪曲##妄下结论
昨天在火车上，我决定要自杀	情绪反应,情绪反应##行为效应
我厌倦了感觉自己像坨屎，我需要平静。	认知歪曲,认知歪曲##乱贴标签
我从两所大学退学，第一次是商学院，第二年没有任何理由就退学了	触发性事件,触发性事件##学习工作
之后，我进入了计算机科学专业，两年半后我退学了，那时我的女朋友和我分手了，因为我对生活没有任何方向感。	触发性事件,触发性事件##学习工作,触发性事件,触发性事件##情感
快进到几个月前，我觉得自己陷入了困境，感觉比以往任何时候都要低落，所以我的应对机制就是喝酒。	认知歪曲,认知歪曲##情绪化推理
几天后我在医院里醒来。离开医院一个星期后，我亲爱的，亲爱的女朋友和我分手了，我对她做了什么，谁能怪她呢，我只是一坨屎。	认知歪曲,认知歪曲##乱贴标签
也许像我这样的人渣不该活着	驳斥,驳斥##习惯性驳斥
也许像我这样的人渣不该活着。	认知歪曲,认知歪曲##乱贴标签
我一生都很沮丧，两年前就想自杀了。	情绪反应,情绪反应##行为效应
我曾经用塑料袋和绳子让自己窒息过一次，但到目前为止就这样了。	情绪反应,情绪反应##行为效应
我和我妹妹谈了很多次，但她似乎总是把它刷掉，因为她经历了一段抑郁的时期，割腕了，但不知怎么的就过去了。	情绪反应,情绪反应##行为效应
每天都有自杀念头。	情绪反应,情绪反应##行为效应
现在当我想自杀的时候，我非常生气，因为我不能自杀而把我的笨妹妹一个人留在那里。	驳斥,驳斥##有效驳斥
现在是凌晨3：50，我正在认真考虑自杀	情绪反应,情绪反应##行为效应
今天，我意识到我不幸被可怕的人包围了。	认知歪曲,认知歪曲##妄下结论
我目前在上大学，已经患抑郁症和焦虑症大约 4 年左右了。	触发性事件,触发性事件##疾病症状,触发性事件,触发性事件##学习工作
我曾两次尝试自杀，但没有成功。	情绪反应,情绪反应##行为效应
我害怕如果我这次尝试失败了，我会受到如此的评判和憎恨	认知歪曲,认知歪曲##妄下结论
我感到不被爱，被背叛，一文不值。	认知歪曲,认知歪曲##情绪化推理,认知歪曲,认知歪曲##乱贴标签
很长一段时间以来，我一直患有抑郁症，现在我有自杀倾向。	触发性事件,触发性事件##疾病症状,情绪反应,情绪反应##行为效应
事情变得很糟糕，有一天我和(B)分手了。	认知歪曲,认知歪曲##妄下结论
我展望未来，把我的大四看作是即将到来的一场我不想忍受的苦难	认知歪曲,认知歪曲##乱贴标签
我在这种沮丧的状态下生活了很长一段时间，希望我能早点死。	情绪反应,情绪反应##行为效应
我们继续交谈，我的健康状况每况愈下，我的精神状况每况愈下，他真的很想帮助我，这让我越来越多地思考我多年来的希望	触发性事件,触发性事件##疾病症状
现在我担心我把事情搞砸了。	认知歪曲,认知歪曲##妄下结论
发短信时的一些情绪爆发几乎毁了我对第二次机会的希望。	认知歪曲,认知歪曲##以偏概全
整个世界一片漆黑，毫无生气。	认知歪曲,认知歪曲##非此即彼
当支撑着我的力量消失时，我决定我的生命将会结束，这就是我现在站在这里的原因。	情绪反应,情绪反应##行为效应
没有告诉包括爸爸在内的任何人，想自杀的念头，记得我在接电话时，一直问他，希望我去以色列吗？	情绪反应,情绪反应##行为效应
因为那时人意外身亡可以给亲属大笔赔偿的国家，生而无用，不如死得其所，不知道他是否体会到我的这层想法，见到他时，感觉他白发陡然增多，我很不孝。	认知歪曲,认知歪曲##乱贴标签
到现在为止，我可能已经抑郁了将近一半的时间	触发性事件,触发性事件##疾病症状
每天我都看到我的朋友过着无忧无虑的生活，但我做的每一件事都被焦虑或无法从沙发上爬起来毁了。	触发性事件,触发性事件##疾病症状
在上个学年的某个时候，我的焦虑达到了几乎每隔一天就会发作一次的程度，结果我有六个多月没有去上学，我告诉自己以后会好起来的。	触发性事件,触发性事件##疾病症状
我看不到我自己的未来，我不知道我怎么能去任何地方因为我他妈的没用，而且真的没什么可改变的。	认知歪曲,认知歪曲##乱贴标签,驳斥,驳斥##习惯性驳斥
过去几周，我几乎每天都在想自杀的事。	情绪反应,情绪反应##行为效应
想象一下如果我让自己从窗户掉下去该有多开心。	情绪反应,情绪反应##行为效应
我现在很迷茫，我不知道该怎么办。	认知歪曲,认知歪曲##情绪化推理
情绪一直都有一些问题，也没有好好的去看过有没有什么病。	触发性事件,触发性事件##疾病症状
我只是觉得未来在我人生中也许存在的最好的可能，在我看来这是我一点都不想过的生活，想来想去都是痛苦，我越来越痛苦，我觉得自己压抑不住了。	认知歪曲,认知歪曲##非此即彼
只想死去。	情绪反应,情绪反应##行为效应
虽然我从来没有被诊断出来，但我知道我从中学开始就患有抑郁症，甚至有自杀的念头	触发性事件,触发性事件##疾病症状
虽然我从来没有被诊断出来，但我知道我从中学开始就患有抑郁症，甚至有自杀的念头。	情绪反应,情绪反应##行为效应
由于严重的焦虑，我从来没能长时间保持一份工作，不再上学，几乎没有钱。	触发性事件,触发性事件##疾病症状,触发性事件,触发性事件##学习工作
我的妹妹是一名护士，我的哥哥在学校成为一名医生，所以这使我成为令人失望的家庭成员。	认知歪曲,认知歪曲##放大和缩小
我觉得自己很没用，什么都做不了，每天都想起床撒尿。	认知歪曲,认知歪曲##否定正面思考,认知歪曲,认知歪曲##乱贴标签
在过去的几个月里，我觉得自己完全失去了任何动力。	认知歪曲,认知歪曲##情绪化推理
我从来没有试图结束自己生命的唯一原因是，在过去的几年里，我对创作和写小说的渴望是唯一一件比我想摆脱这种持续的痛苦更重要的事情。	驳斥,驳斥##有效驳斥
他们弄脏或损坏的任何东西都是我的错，或者我有责任更换。(抱歉，这部分更像是咆哮)想要为任何事情而活越来越难了。	认知歪曲,认知歪曲##罪责归己/他
我的任何希望和抱负似乎都太不现实，不可能实现。	驳斥,驳斥##习惯性驳斥
如果我可以用《黑暗之魂》中的例子来说明我的感受，那就像置身于Sens Fortress，被困在两个摇摆的钟摆之间，只剩下最后一点生命值，没有estus或人性，也看不到篝火。	认知歪曲,认知歪曲##情绪化推理
不管我怎么喊，都没有答案。	驳斥,驳斥##习惯性驳斥
做人如此的失败。也不配有家，麻木地去寻找解脱，不想死在熟悉的环境，死后还要被舆论评议，也不想曝尸街头成为社会新闻。	认知歪曲,认知歪曲##妄下结论,认知歪曲,认知歪曲##乱贴标签
拦下一辆出租车，让司机开到临近的市，不敢选择跳楼这么激烈的死法，考虑吃安眠药，割腕或者自溺。	情绪反应,情绪反应##行为效应
在我的生活中，我有很多朋友和女朋友，其中一些人仍然迷恋着我。	认知歪曲,认知歪曲##妄下结论
我之前甚至公然告诉过朋友，但没人把我当回事。	认知歪曲,认知歪曲##妄下结论
我感觉被孤立了	认知歪曲,认知歪曲##情绪化推理
没人发现我在用最微妙的方式故意自杀。	情绪反应,情绪反应##行为效应
也许如果我吸毒过量，我的家人就不会那么伤心了。	认知歪曲,认知歪曲##妄下结论
最近我全身都有慢性疼痛，我一直在用海洛因、酒精和其他任何能让我忘记疼痛的东西来治疗	触发性事件,触发性事件##疾病症状
事实上，我对死亡的准备比什么都充分	情绪反应,情绪反应##行为效应
我把生活搞砸了两次，还不如结束。	认知歪曲,认知歪曲##放大和缩小
这打乱了我的学习，到了第二学期我就不及格了。	触发性事件,触发性事件##学习工作
现在我只等着圣诞节后结束我的生命，找到一种无痛的方式	情绪反应,情绪反应##行为效应
我不想再活了。	认知歪曲,认知歪曲##非此即彼
生活毫无意义。	驳斥,驳斥##习惯性驳斥
020年1月，我被诊断出患有边缘型人格障碍，这对我造成了严重影响	触发性事件,触发性事件##疾病症状
每当我和妈妈吵架时，我总是错的一方	认知歪曲,认知歪曲##以偏概全
我只想死	情绪反应,情绪反应##行为效应
延长我们死前的时间是毫无意义的:因为无论如何我们将来都会死。	认知歪曲,认知歪曲##非此即彼
人类都是没用的，自私的垃圾。	认知歪曲,认知歪曲##乱贴标签
这是毫无意义的。	驳斥,驳斥##习惯性驳斥
我什么都没有	驳斥,驳斥##有效驳斥
我过着单调的日常生活，没有任何期待，也没有任何抱负。	驳斥,驳斥##有效驳斥
我肯定她后悔和我在一起，我不怪她。	认知歪曲,认知歪曲##妄下结论
这些天我除了伤害她什么都没做。	认知歪曲,认知歪曲##罪责归己/他
我知道这对我周围的人是不公平的，我也知道这不是他们想要的，但是我不能总是一个人想着自己。	认知歪曲,认知歪曲##罪责归己/他
我的想法是极度自我毁灭的。	情绪反应,情绪反应##行为效应
我恋爱了，我感到被爱。	触发性事件,触发性事件##情感
我在赶走她，最终我再也不会有最好的朋友了。	认知歪曲,认知歪曲##以偏概全
我将完全孤独。	认知歪曲,认知歪曲##以偏概全
我在这个世界上一无所有，这就是我现在的感受。	认知歪曲,认知歪曲##放大和缩小
她让我意识到问题出在我身上，是我的错，我的关系总是破裂。	认知歪曲,认知歪曲##罪责归己/他,认知歪曲,认知歪曲##以偏概全
我就是完全不可爱。	认知歪曲,认知歪曲##乱贴标签
我让他们窒息	认知歪曲,认知歪曲##放大和缩小
在过去的两周里，我一直处于极度抑郁之中。	触发性事件,触发性事件##疾病症状
我几乎没有什么可以提供的，主要是她在开车，这一定很累人。	认知歪曲,认知歪曲##妄下结论
如果我从地球上掉下来，或者消失在遗忘中，世界上没有人会注意到。	认知歪曲,认知歪曲##妄下结论
我曾经想自杀是因为觉得自己活得实在太糟糕了，不想再承担任何责任，并且有很严重的自残行为。	情绪反应,情绪反应##行为效应
是因为觉得自己活得实在太糟糕了	认知歪曲,认知歪曲##情绪化推理
我的心理健康在过去的几个月里直线下降，我一整年都在幻想自残	情绪反应,情绪反应##行为效应
对我来说，通往天堂的路已经被我的性取向毁了。	认知歪曲,认知歪曲##放大和缩小
活了21年，从来没有人爱过我。	认知歪曲,认知歪曲##以偏概全
我是一个毫无价值的未出柜同性恋，我觉得整个世界都在嘲笑我	认知歪曲,认知歪曲##妄下结论
等我上吊自杀，我就笑到最后了。	情绪反应,情绪反应##行为效应
生活中没有什么能给我带来真正的快乐。	驳斥,驳斥##习惯性驳斥
心碎了，充满了绝望。	认知歪曲,认知歪曲##妄下结论
她是无可替代的，在各方面都很完美，我从来没有勇气告诉她我自己对她的看法。	认知歪曲,认知歪曲##放大和缩小
我或多或少地克服了小时候困扰我的严重的社交焦虑，但似乎只要我一想到接近她，这些焦虑就会全面袭来。	触发性事件,触发性事件##疾病症状
每次想到她，我都感到绝望，她可能早就离开我了，根本不在乎我。	认知歪曲,认知歪曲##妄下结论
我想死。	情绪反应,情绪反应##行为效应
自杀是一个非常现实的选择，现在我16岁，我讨厌我的生活。	情绪反应,情绪反应##行为效应
在过去三年左右的时间里，我断断续续地抑郁，有时甚至很严重。	触发性事件,触发性事件##疾病症状
我也患有相当严重的社交焦虑症，从来没有走出家门去见我仅有的几个朋友，我的意思是从来没有。	触发性事件,触发性事件##疾病症状
我在学校里因为一些小蠢事惹上了麻烦，我的蛋蛋都被砸了。	认知歪曲,认知歪曲##放大和缩小
我很伤心，看不到任何摆脱这种糟糕生活的方法，也看不到任何令人愉快的未来。	驳斥,驳斥##习惯性驳斥
我有办法，我计划在学校里做，比如在厕所或某个角落走廊的空闲时间。	情绪反应,情绪反应##行为效应
在过去的五年里，我的生活就像地狱一样	认知歪曲,认知歪曲##乱贴标签
21岁和家人一起做生意，被很多人欺骗和欺骗，差点让我的婚姻破裂。	触发性事件,触发性事件##学习工作,触发性事件,触发性事件##情感
我的压力和焦虑水平已经达到了极限，我都不记得快乐是什么感觉了	触发性事件,触发性事件##疾病症状
我的家人背叛了我，抛弃了我，一年多来都没有联系过我。	触发性事件,触发性事件##情感
我想我都要破产了	认知歪曲,认知歪曲##放大和缩小
我一直在努力，但要么搞砸了，要么被搞砸了，我已经厌倦了。	认知歪曲,认知歪曲##非此即彼
我真的不想自杀，但是我现在真的特别想从这22楼跳下去，我真的是忍不住了，我自己觉得我还挺坚强的，但是现在我真的没有勇气，没有能力再乐观的面对生活了。	驳斥,驳斥##习惯性驳斥,驳斥,驳斥##有效驳斥
与抑郁、社交焦虑、自卑、每天都有自杀的念头作斗争。	触发性事件,触发性事件##疾病症状
我在经济上依赖我的父母。	触发性事件,触发性事件##学习工作
我没有工作，也没有上学	触发性事件,触发性事件##学习工作
我的家人不爱我	认知歪曲,认知歪曲##妄下结论
我讨厌感觉自己毫无价值、不受欢迎。	认知歪曲,认知歪曲##情绪化推理
我做的每件事都搞砸了	认知歪曲,认知歪曲##放大和缩小
。我讨厌每天醒来都觉得自己一无是处	认知歪曲,认知歪曲##乱贴标签
现在，我只想结束这一切。	情绪反应,情绪反应##行为效应
以来几星期我和我的女朋友分手了,因为我们不交谈了,感觉我的错,我知道她告诉我它不是我的错,但是为什么感觉和日常我想假装它是好的那将持续,但是我们在一起4年8年级,我们的关系是强高中毕业后我们将讨论如何搬到一个乡村之类的但是这检疫发生我们彼此失去了联系,她就失去了兴趣,我有一天她给我,我们的关系不会工作我真的很伤心,自从我有关于自杀的想法,但我不能完成它,因为我害怕我会伤害我的祖父母，所以我一直假装自己没事。	认知歪曲,认知歪曲##妄下结论,驳斥,驳斥##有效驳斥
当我一个人在房间里想我什么都没做对，我做错了所有时，我会哭着睡觉，我每天都感到绝望。	认知歪曲,认知歪曲##放大和缩小,认知歪曲,认知歪曲##情绪化推理
我这种人活着也没意义呀	情绪反应,情绪反应##情感效应
家里面人都说我这种人活着就是社会的败类	认知歪曲,认知歪曲##乱贴标签
只有小时候他打我，拎着我衣领拖我走，我的鼻血流了一地	触发性事件,触发性事件##生活
我觉得继续我的生活没有意义	情绪反应,情绪反应##情感效应
冷漠的民众伤害和虐待自己，绝大多数人没有同情心	触发性事件,触发性事件##社会关系
我是另一个愚蠢的人类状况的追随者	认知歪曲,认知歪曲##乱贴标签
我无法理解为什么有人想要生活在这样痛苦的生活中	认知歪曲,认知歪曲##心理过滤
我可以离开这个地狱般的地方，事情可能会有所不同。但就目前的情况来看，无论如何我都会死去很久，看不到我梦寐以求的东西。	认知歪曲,认知歪曲##妄下结论
知道这么多其他人也有同样的感觉，这让我更加坚定了这一点。我试过的都没用	认知歪曲,认知歪曲##情绪化推理
我曾经信任的那个能帮助我的人跑到另一个人的怀抱里去了	触发性事件,触发性事件##情感
没有什么能挡在我和地狱之间我一直都想避开它，所以忍受它又有什么意义呢	认知歪曲,认知歪曲##非此即彼
我只想睡着，再也不要醒来，再也不要有任何感觉	情绪反应,情绪反应##情感效应
我想死	情绪反应,情绪反应##情感效应
身为尝试自杀数次的绝症、忧郁症患者之一	触发性事件,触发性事件##疾病症状,情绪反应,情绪反应##行为效应
真的非常反感	情绪反应,情绪反应##情感效应
我已经和抑郁和焦虑斗争了3年	触发性事件,触发性事件##疾病症状
当我遇到我的新女友时，我觉得我太迷恋她了	触发性事件,触发性事件##情感
开始窒息甚至割伤自己	情绪反应,情绪反应##行为效应
如果她离开我，我的生活就没有其他目标了	认知歪曲,认知歪曲##心理过滤
我没有朋友	触发性事件,触发性事件##社会关系
我的家人把我看得一文不值	触发性事件,触发性事件##生活
只是我的思想让我觉得她把我当狗屎一样	认知歪曲,认知歪曲##乱贴标签
因为我活该所以我活该受苦	认知歪曲,认知歪曲##妄下结论
这是一段健康的关系吗	驳斥,驳斥##有效驳斥
如果我们分手了，我会自杀	情绪反应,情绪反应##行为效应
但我想改变	驳斥,驳斥##有效驳斥
我想成为她能拥有的最好的人	驳斥,驳斥##有效驳斥
垃圾，这就是我	认知歪曲,认知歪曲##乱贴标签
我知道有人爱我，会想念我;我的生活并没有因为这些知识而变得更糟	驳斥,驳斥##有效驳斥
现在我感觉离第4次更近了，这是一个更最终、更明确的行动	情绪反应,情绪反应##行为效应
我不想死，但我找不到继续活下去的理由	驳斥,驳斥##习惯性驳斥
我没有给这个世界带来任何有价值的东西	认知歪曲,认知歪曲##否定正面思考
很累	情绪反应,情绪反应##情感效应
离婚	触发性事件,触发性事件##情感
带一个孩子	触发性事件,触发性事件##生活
父亲去世	触发性事件,触发性事件##生活
想到我一向努力积极，人生他妈的混成这样，是不是怎么咬着牙忍住痛微笑都会迎来又一次的打击	认知歪曲,认知歪曲##情绪化推理
绝望	情绪反应,情绪反应##情感效应
这里是五楼，我在想如果跳下去会不会好一点	情绪反应,情绪反应##行为效应
我知道这极其不负责任，可是我不会告诉你	驳斥,驳斥##习惯性驳斥
等到我无法承受的时候就打扮的漂漂亮亮，吃得好好的去自杀	情绪反应,情绪反应##行为效应
我想一定干干脆脆的自杀	情绪反应,情绪反应##行为效应
我是维系他们婚姻的唯一支柱	触发性事件,触发性事件##生活
我猜他们已经厌倦了彼此，甚至都不是假装的	认知歪曲,认知歪曲##情绪化推理
当我问他们冷食袋(不知道怎么叫，就是去杂货店放冷冻食品的袋子)之类的东西在哪里时，没有人眨一下眼睛帮我找到它	触发性事件,触发性事件##社会关系
我的工作也是如此	触发性事件,触发性事件##学习工作
我感到非常孤独	情绪反应,情绪反应##情感效应
没有人可以依靠	情绪反应,情绪反应##情感效应
整个世界都让我恶心	认知歪曲,认知歪曲##心理过滤
已经试过两次	情绪反应,情绪反应##行为效应
绝望	情绪反应,情绪反应##情感效应
我希望我能再次拥有一些东西	驳斥,驳斥##有效驳斥
但现在一切都糟透了，我满脑子想的都是我的生活不再值得活下去了。	认知歪曲,认知歪曲##情绪化推理
我无家可归。我叔叔把我赶了出去	触发性事件,触发性事件##生活
我太不受欢迎了。我不再被需要了	认知歪曲,认知歪曲##情绪化推理
我非常非常害怕。我害怕独自一人	情绪反应,情绪反应##情感效应
我感到很绝望	情绪反应,情绪反应##情感效应
我想成为一名老师!我想去韩国旅游，教英语!我想看看这个世界，帮助孩子们!	驳斥,驳斥##有效驳斥
我不想成为一个可悲的浪费空间的人。我不想再给世界带来负担了。	驳斥,驳斥##有效驳斥
我想结束这一切来弥补我浪费了大家的时间和精力	情绪反应,情绪反应##情感效应
感觉再也没有什么值得我为之活下去的了，我曾经做过的每一个让我坚持下去的梦想现在都变得不可能了	认知歪曲,认知歪曲##以偏概全
大约从11月开始，我的精神状态就不太好	触发性事件,触发性事件##疾病症状
失去了一份工作	触发性事件,触发性事件##学习工作
无法养活自己	触发性事件,触发性事件##生活
我和前男友一周半前分手了	触发性事件,触发性事件##情感
我相信我活不到25岁	认知歪曲,认知歪曲##妄下结论
我太伤心，太害怕，不敢独自进入虚无	情绪反应,情绪反应##情感效应
但我觉得自杀是我应该做的事	认知歪曲,认知歪曲##应该句式
我多年来一直在计划着同样的遗书，并且经常把它放在钱包里	情绪反应,情绪反应##行为效应
有时我在快乐/希望(即使它们是虚假的)和绝望之间如此频繁地来回转换，这让我很痛苦	情绪反应,情绪反应##情感效应
父母对我的高度近视一直是嘲讽态度	触发性事件,触发性事件##生活
已经发展成弱视了带1000度的镜子也看不到0.4	触发性事件,触发性事件##生活
十分钟之前爸爸刚跟妈妈通电话说欠的钱还不上房贷也还不上的话了	触发性事件,触发性事件##生活
那就去寻死吧。反正或者也没希望。	情绪反应,情绪反应##情感效应
我害怕	情绪反应,情绪反应##情感效应
我认为我是跨性别者，但我甚至不确定这一点。我不知道我只是在对自己撒谎，还是我真的是跨性别者	触发性事件,触发性事件##生活
我感到被思想和情绪淹没了	情绪反应,情绪反应##情感效应
昨天第一次割伤自己	情绪反应,情绪反应##行为效应
我甚至几乎没有出血，所以我他妈的不能正确地伤害自己	认知歪曲,认知歪曲##情绪化推理
我不认为我能正确地做任何事情	认知歪曲,认知歪曲##否定正面思考
但我知道除非我成名，否则在这个领域找不到钱	认知歪曲,认知歪曲##非此即彼
我还没有认真讨论自杀，但想法不断回来，而且越来越糟	情绪反应,情绪反应##情感效应
我想哭	情绪反应,情绪反应##情感效应
糟糕的二十年，永远不会好转	认知歪曲,认知歪曲##否定正面思考
在学校里一直受到严重的欺凌	触发性事件,触发性事件##生活
我有一个非常混乱的关系包括一些最近我有闪回的记忆，让我认为他是计划严重伤害我或者强奸我	触发性事件,触发性事件##疾病症状
我也是一个变性人	触发性事件,触发性事件##社会关系
这让我很沮丧，我的父母永远不会同意我的生活	认知歪曲,认知歪曲##情绪化推理
我完全讨厌我的生活	认知歪曲,认知歪曲##否定正面思考
我对我的未来找不到任何希望	认知歪曲,认知歪曲##心理过滤
我想我可能会在今晚结束它。	情绪反应,情绪反应##行为效应
我将自杀	情绪反应,情绪反应##行为效应
我没有朋友和家人	触发性事件,触发性事件##社会关系
我需要6000英镑做手术，但我筹不到钱	触发性事件,触发性事件##生活
我一直很沮丧	情绪反应,情绪反应##情感效应
我觉得自己成了朋友和父母的累赘	触发性事件,触发性事件##社会关系
我止不住地哭	情绪反应,情绪反应##情感效应
因为我觉得自己一无是处。	认知歪曲,认知歪曲##否定正面思考
我今天就想死	情绪反应,情绪反应##行为效应
她是我生命的全部	认知歪曲,认知歪曲##放大和缩小
分手	触发性事件,触发性事件##情感
我没有朋友	触发性事件,触发性事件##社会关系
每个人都指着我，嘲笑我	认知歪曲,认知歪曲##心理过滤
这让我心烦意乱	情绪反应,情绪反应##情感效应
割伤自己	情绪反应,情绪反应##行为效应
没有她我活不下去	认知歪曲,认知歪曲##放大和缩小
如果到下周五她还不跟我打招呼，我就去上吊自杀	情绪反应,情绪反应##行为效应
我吃了一大堆安眠药	情绪反应,情绪反应##行为效应
我一直有轻微的幻觉	触发性事件,触发性事件##疾病症状
我失去了我生命中最好的朋友，我最爱的人	触发性事件,触发性事件##社会关系
在过去的七个月里，唯一支撑我活下去的就是她，现在我失去了她，我不明白为什么我还想活下去	认知歪曲,认知歪曲##非此即彼
我几乎没有家人	触发性事件,触发性事件##生活
我已经抑郁了很长时间了	触发性事件,触发性事件##疾病症状
但她为了另一个人离开了我	触发性事件,触发性事件##情感
大学毕业后我所有的朋友都走了。我在大学里没有朋友。我没有朋友。	触发性事件,触发性事件##社会关系
多年来我一直想自杀	情绪反应,情绪反应##行为效应
我也想过割腕，	情绪反应,情绪反应##行为效应
我想过要跳窗自杀	情绪反应,情绪反应##行为效应
我想过把所有的药都吃了	情绪反应,情绪反应##行为效应
我想说的是，我很孤独	情绪反应,情绪反应##情感效应
发现我的朋友们认为我被强奸是罪有应得，然后互相讨论我受够了	触发性事件,触发性事件##生活
我厌倦了一直试图从内疚，自责和自我厌恶中解脱出来	情绪反应,情绪反应##情感效应
我几乎每天都想死于创伤后应激障碍	情绪反应,情绪反应##情感效应
有时我想死，因为我不相信即使我完成了治疗，也会有任何东西毫发无损。	认知歪曲,认知歪曲##否定正面思考
我不小心杀死了我的宠物虎皮鹦鹉	触发性事件,触发性事件##生活
我也开始逃课和考试，现在基本上是不及格的大学	触发性事件,触发性事件##学习工作
我也有社交焦虑症	触发性事件,触发性事件##疾病症状
我的整个家庭也很讨厌我	触发性事件,触发性事件##生活
把我当狗屎一样对待	认知歪曲,认知歪曲##乱贴标签
我没有朋友	触发性事件,触发性事件##社会关系
我没有生活	触发性事件,触发性事件##生活
我觉得太累了，我觉得我的生活已经结束了，我只想休息	情绪反应,情绪反应##情感效应
我一直在想把家里所有的药片都喝光	情绪反应,情绪反应##行为效应
外出打工的父亲偷偷回家带走了母亲	触发性事件,触发性事件##生活
给我丢了两百块钱让我自生自灭	触发性事件,触发性事件##生活
如果到12月30日还没有好转，我就自杀	情绪反应,情绪反应##行为效应
从3岁起，我就开始应对焦虑、强迫症和恐慌。我会把我的玩具排成一排，如果少了一个，我就会发疯。恐惧升级到疾病、罕见疾病和清洁。有半年的时间，我每天要洗手20次。	触发性事件,触发性事件##疾病症状
女朋友三个月前和我分手了	触发性事件,触发性事件##情感
我完全沉浸在自己的头脑中，甚至无法真正感受到情感	触发性事件,触发性事件##疾病症状
我总是很沮丧	情绪反应,情绪反应##情感效应
即使有更好的时光，也不值得。这就是我，我永远无法摆脱自己的想法。	认知歪曲,认知歪曲##情绪化推理
我告诉我妈妈我还不想去上学，因为我8月份就满18岁了，我真的很想休息一段时间	触发性事件,触发性事件##学习工作
但是她强迫我去上学	触发性事件,触发性事件##生活
现在我每门课都不及格	触发性事件,触发性事件##学习工作
老实说，我不认为除了自杀还有别的选择	认知歪曲,认知歪曲##非此即彼
压力太大了	触发性事件,触发性事件##学习工作
身体畸形	触发性事件,触发性事件##生活
我今年21岁，从11岁起我就得了贪食症。去年，情况变得更糟	触发性事件,触发性事件##疾病症状
我交往了三年的女朋友和我分手了	触发性事件,触发性事件##情感
新冠疫情封锁	触发性事件,触发性事件##生活
新冠疫情封锁快把我逼疯了。我都不知道朋友是什么了。我觉得我和任何人都没有真正的联系	认知歪曲,认知歪曲##情绪化推理
我都不知道朋友是什么了。	认知歪曲,认知歪曲##放大和缩小
我觉得好恶心，好卑鄙。我恨死自己了	情绪反应,情绪反应##情感效应
今年我已经三次试图自杀了	情绪反应,情绪反应##行为效应
这也不是第一次自杀了，算上之前的吃药，开煤气，试图跳楼，上吊，这次是第四次	情绪反应,情绪反应##行为效应
但愿常梦不愿醒，何况是一场舒爽的无梦安眠。	情绪反应,情绪反应##情感效应
我从没想过我能活着看到这一天	认知歪曲,认知歪曲##妄下结论
我第一次试图自杀是在18岁的时候	情绪反应,情绪反应##行为效应
被诊断患有精神分裂症	触发性事件,触发性事件##疾病症状
我意识到，无论我外表看起来多么快乐，我都只是一个空洞的躯壳。	认知歪曲,认知歪曲##否定正面思考,认知歪曲,认知歪曲##乱贴标签
我什么都不在乎	认知歪曲,认知歪曲##妄下结论
我想起了那种想死的感觉	情绪反应,情绪反应##情感效应
我恨我自己	认知歪曲,认知歪曲##罪责归己/他
我觉得自己很烦人，令人讨厌，难以忍受	认知歪曲,认知歪曲##乱贴标签
我太吵了。太孩子气了。太愚蠢。	认知歪曲,认知歪曲##乱贴标签
我尴尬。我不擅长生活。我非常不负责任。我甚至连作业都做不好。我不能保持我的生活井井有条。	认知歪曲,认知歪曲##情绪化推理
我甚至不知道我能不能成为社会的一员。	触发性事件,触发性事件##社会关系
我几乎不能保住我的最低工资工作	触发性事件,触发性事件##学习工作
它让我发现自己是如此的糟糕和没有吸引力	认知歪曲,认知歪曲##放大和缩小
我讨厌自己没有勇气	认知歪曲,认知歪曲##乱贴标签
我真心实意地爱上了他。但我甚至没有勇气告诉他我被他吸引了，更不用说我的感情有多深了。	触发性事件,触发性事件##情感
谁会爱这么可悲的人呢?谁会觉得像我这样的人有一点吸引力呢?	认知歪曲,认知歪曲##情绪化推理
然后是学生贷款的财务问题	触发性事件,触发性事件##学习工作
还有我父母的关系	触发性事件,触发性事件##社会关系
不管我做什么，我总是他们吵架的原因	认知歪曲,认知歪曲##罪责归己/他
我很确定没有我大家的生活会更好	认知歪曲,认知歪曲##妄下结论
坚持到底有什么意义	认知歪曲,认知歪曲##否定正面思考
这些感觉我已经有好几年了，从来没有好转过	认知歪曲,认知歪曲##否定正面思考
也许我早就该死了。也许我根本就不该出生。	认知歪曲,认知歪曲##情绪化推理
我知道如果我离开他们，会让很多人伤心。这是唯一阻止我的事，我就快成功了已经不重要了。	驳斥,驳斥##习惯性驳斥
自己却慢慢有了这个念头	情绪反应,情绪反应##情感效应
四岁就得了慢性肾炎，到十岁病危了四次，后面的几年也过的战战兢兢，可以说我整个童年都是贫穷加药丸的记忆	触发性事件,触发性事件##疾病症状
二十六岁慢性肾炎又犯了，在这七八年里反复了好多次	触发性事件,触发性事件##疾病症状
但我觉得我应该结束我的生命	认知歪曲,认知歪曲##妄下结论
我永远不会完成任何事情	认知歪曲,认知歪曲##否定正面思考
但我还是觉得自己太蠢了	认知歪曲,认知歪曲##乱贴标签
我确实有朋友，但是我对他们感到极度焦虑，以至于我总是离开	触发性事件,触发性事件##社会关系
回家割伤自己	情绪反应,情绪反应##行为效应
我不知道该做什么，也不知道该告诉谁，但我就在结束这一切的边缘	认知歪曲,认知歪曲##情绪化推理
有时真想捅自己几刀，死了算了	情绪反应,情绪反应##情感效应
生活没有什么乐趣，忧虑没法排解，对未来存在焦虑	认知歪曲,认知歪曲##否定正面思考
没钱，买不起房子	触发性事件,触发性事件##生活
如果我死了那么爸爸就不会死	认知歪曲,认知歪曲##罪责归己/他
而且爷爷奶奶都不喜欢我，妈妈也不要我	触发性事件,触发性事件##社会关系
我是没人要的、多余的小孩	认知歪曲,认知歪曲##乱贴标签
那时还小，学电视上吞金自杀，就吞了两颗纽扣，但并没有什么反应	情绪反应,情绪反应##行为效应
就在刚刚想要自杀，想要从楼上一跃而下	情绪反应,情绪反应##情感效应
给妈妈打电话，一句安慰都没有，然后打车回家，上来就骂我，说我没用，为什么别人不摔倒	触发性事件,触发性事件##社会关系
就在那一刻，想要跳楼	情绪反应,情绪反应##情感效应
我自己也觉得我自己没用啊，活着还干什么	认知歪曲,认知歪曲##情绪化推理
从小就没有安全感，这就是原生家庭环境的影响	触发性事件,触发性事件##社会关系
感觉自己突然好孤独	情绪反应,情绪反应##情感效应
我身无分文，如果我能完成论文就要大学毕业了	触发性事件,触发性事件##学习工作
这整个冒险都是浪费时间	认知歪曲,认知歪曲##妄下结论
我只有一个朋友	触发性事件,触发性事件##社会关系
我的父母讨厌我	触发性事件,触发性事件##社会关系
我有一份工作，但两周后才发工资，大概50美元	触发性事件,触发性事件##学习工作
没有钱付房租	触发性事件,触发性事件##生活
我是变性人，我没有钱支付治疗费用	触发性事件,触发性事件##生活
我想我今晚要自杀了	情绪反应,情绪反应##情感效应
我知道如果我这么做会让爱我的人难过，我一直在让自己活着	驳斥,驳斥##习惯性驳斥
但现在我只是怨恨他们让我活着	认知歪曲,认知歪曲##情绪化推理
恐怕得有人来对付我，而我的室友要来对付我的空房间。这些是我今天还活着的唯一原因。	驳斥,驳斥##有效驳斥
既然生了先天残疾的我	触发性事件,触发性事件##疾病症状
一个男人这样唯唯诺诺，	认知歪曲,认知歪曲##乱贴标签
我真的好几次想过自杀	情绪反应,情绪反应##情感效应
我大一时候想要尝试饿肚子不吃饭的方式自杀	情绪反应,情绪反应##行为效应
我准备结束自己这无聊的一生	情绪反应,情绪反应##情感效应
这样世界上就少了一个傻子	认知歪曲,认知歪曲##乱贴标签
我要在夜深人静的时候找一片无人的湖面噗通一声跳下去	情绪反应,情绪反应##情感效应
这样就算我这个懦弱的人想要中断也没有办法了。	认知歪曲,认知歪曲##乱贴标签
我一直在想自杀的事	情绪反应,情绪反应##情感效应
我离开了一段受虐待的关系，离开了小镇，离开了所有的朋友。	触发性事件,触发性事件##社会关系
我经历过几段走下坡路的感情，给我带来了创伤。	触发性事件,触发性事件##情感
，而我所有的问题都在拖累他	认知歪曲,认知歪曲##罪责归己/他
除了抑郁、焦虑和创伤后应激障碍外，我还有身体健康问题。	触发性事件,触发性事件##疾病症状
我不能保住工作，我一直在努力，但失败了。	触发性事件,触发性事件##学习工作
我在考虑申请残疾，但我觉得我只是在找借口，不值得。	认知歪曲,认知歪曲##情绪化推理
我刚刚失去了工作	触发性事件,触发性事件##学习工作
我觉得很尴尬，觉得他们无论如何都会解雇我。	认知歪曲,认知歪曲##情绪化推理
我知道我应该坚持到底。	认知歪曲,认知歪曲##应该句式
他告诉我他不开心，而且他的焦虑非常高，因为他承受着巨大的压力。他告诉我他真的爱我，希望我们能继续下去，但他觉得我没有努力。	触发性事件,触发性事件##社会关系
我觉得对我的家人和男朋友来说，我是一个负担	认知歪曲,认知歪曲##罪责归己/他
我觉得我毁了本来可能是好事的东西。	认知歪曲,认知歪曲##妄下结论
我觉得好像没有我这个世界会更好。	认知歪曲,认知歪曲##妄下结论
我不断有这样的想法，也许我该走了。	情绪反应,情绪反应##情感效应
我觉得我没有能力过正常的生活	认知歪曲,认知歪曲##妄下结论
我试过心理治疗，没用。我在服用大剂量的百忧解，它一度有用，但最近没用了	触发性事件,触发性事件##疾病症状
我只是觉得很失落。	情绪反应,情绪反应##情感效应
内心深处阴暗到无药可救	认知歪曲,认知歪曲##乱贴标签
身边的朋友慢慢变少	触发性事件,触发性事件##社会关系
麻木到没有任何感觉。	情绪反应,情绪反应##情感效应
我的悲伤完全不能用语言来形容，	情绪反应,情绪反应##情感效应
就算我心情真的特别好我也想去死。	情绪反应,情绪反应##情感效应
最终我将不得不自杀。	认知歪曲,认知歪曲##情绪化推理,情绪反应,情绪反应##情感效应
身体畸形和身体健康问题。	触发性事件,触发性事件##疾病症状
成为一个抱怨者	认知歪曲,认知歪曲##乱贴标签
我的身体比例有一个独特的问题，	触发性事件,触发性事件##疾病症状
我的背部和腿筋总是在做正常的事情时酸痛。这个问题不仅是身体上的，而且改变了我的身体外观，所以我患上了严重的社交焦虑症。	触发性事件,触发性事件##疾病症状
我觉得我看起来太奇怪了，因为我的大腿骨看起来太奇怪了。	认知歪曲,认知歪曲##乱贴标签
几乎没有人际交往	触发性事件,触发性事件##社会关系
看到儿子这样，他们也会哭。	触发性事件,触发性事件##社会关系
最终孤独和痛苦的反复循环会导致我自杀。	认知歪曲,认知歪曲##情绪化推理
我大学又不及格了	触发性事件,触发性事件##学习工作
我想自杀。	情绪反应,情绪反应##情感效应
我大学考试不及格两次。我失业好几年了	触发性事件,触发性事件##学习工作
我没有什么好的资历。	认知歪曲,认知歪曲##妄下结论
治疗有一段时间是有用的，因为在大学里是免费的，但离开学校我负担不起。	触发性事件,触发性事件##生活
我真的很想结束我的生命	情绪反应,情绪反应##情感效应
我不想再醒来了。	情绪反应,情绪反应##情感效应
我再也没有动力去做任何事了。	认知歪曲,认知歪曲##情绪化推理
我只想死。	情绪反应,情绪反应##情感效应
我对任何人或任何事都没有真正的影响。	认知歪曲,认知歪曲##情绪化推理
我笨手笨脚	认知歪曲,认知歪曲##乱贴标签
我笨手笨脚，把一切都搞砸。	认知歪曲,认知歪曲##情绪化推理
我都不知道自己在做什么了。	触发性事件,触发性事件##学习工作
不，是我的问题，我是个懒惰的混蛋，没有能力理解或适应。	认知歪曲,认知歪曲##罪责归己/他
我是个懒惰的混蛋，	认知歪曲,认知歪曲##乱贴标签
要么我根本睡不着，要么我睡得太多了。	情绪反应,情绪反应##行为效应
稍有变化我就生气	情绪反应,情绪反应##情感效应
我不再有动力去做我曾经做过的事情	情绪反应,情绪反应##情感效应
我真的不想和任何人说话。	情绪反应,情绪反应##情感效应
我觉得我是一个自命不凡的混蛋	认知歪曲,认知歪曲##乱贴标签
明年我要自杀	情绪反应,情绪反应##情感效应
我已经设定了储蓄和目标，	情绪反应,情绪反应##行为效应
我真的没什么好难过的，但我还是很难过。	情绪反应,情绪反应##情感效应
我内心一直有一种空虚的感觉	情绪反应,情绪反应##情感效应
脑子里满是不好的想法	认知歪曲,认知歪曲##心理过滤
，感觉就像我把他们拉下来了，或者我在寻求关注，结果感觉更糟。	认知歪曲,认知歪曲##妄下结论
我感到很平静	情绪反应,情绪反应##情感效应
耐心和爱	情绪反应,情绪反应##情感效应
我的姐妹们取笑我	触发性事件,触发性事件##社会关系
我的朋友们成家立业，我知道他们一定会成功	认知歪曲,认知歪曲##妄下结论
成绩不突出，拿不到奖学金，申请助学金有困难，贷款毕业后还是要还。高数怎么也考不过，很有可能拿不到学士证，根本不会有好的推荐。	触发性事件,触发性事件##学习工作
家里需要十几万	触发性事件,触发性事件##生活
家里人病的病，临危的临危。	触发性事件,触发性事件##生活
不如赶快死去，摆脱一切。	情绪反应,情绪反应##情感效应
除了一杯水，我已经三天没有吃过或喝过任何东西了。有一次我的父母在他们惯常的精神虐待之后第一次打我，我再也无法忍受了，我说了一些难听的话，从那以后我就一直呆在我的房间里。	触发性事件,触发性事件##生活
我不要求爱或支持，我很不幸，这两样东西我都没有。	认知歪曲,认知歪曲##情绪化推理
但他们想让我死，他们已经证明了这一点。	认知歪曲,认知歪曲##情绪化推理
他们是怪物，他们所信仰的地狱是他们应得的。	认知歪曲,认知歪曲##情绪化推理
我真的是一个顽童	认知歪曲,认知歪曲##乱贴标签
我讨厌自己，因为无论我多么想改变，我都做不到。	认知歪曲,认知歪曲##以偏概全
我觉得自己就像那些讨厌的前卫青少年，我可能就是其中之一。	认知歪曲,认知歪曲##乱贴标签
我知道，无论我是死是活，我都只是一个令人失望的人	认知歪曲,认知歪曲##乱贴标签
不如试试死吧?	驳斥,驳斥##习惯性驳斥
生活对我来说没什么意义。	驳斥,驳斥##习惯性驳斥
我从未觉得自己正常过	认知歪曲,认知歪曲##否定正面思考
我最好的朋友自杀了，我被一个压抑了十年的邻居强奸了，糟糕的家庭生活，女孩们因为各种各样的原因利用我	触发性事件,触发性事件##生活
我已经毕业了，但我还没有申请春季班，工作，或任何真正的东西	触发性事件,触发性事件##学习工作
我他妈是个失败者	认知歪曲,认知歪曲##乱贴标签
但这已经持续了14年，我真的很累了	情绪反应,情绪反应##情感效应
我毫无价值。我是一坨屎。我配不上我的男朋友	认知歪曲,认知歪曲##否定正面思考
我是一坨屎	认知歪曲,认知歪曲##乱贴标签
我被每月400美元的汽车租赁费困住了	触发性事件,触发性事件##生活
我想放弃一门给我带来很大压力的课，但这样我就得付学费了，我负担不起。	触发性事件,触发性事件##学习工作
我总是生病，我很确定每个人都认为我是假装的	认知歪曲,认知歪曲##妄下结论
我准备好去死了	情绪反应,情绪反应##行为效应
从中学开始，我就想自杀	情绪反应,情绪反应##行为效应
我只想结束这一切。	情绪反应,情绪反应##行为效应
我的逻辑已经从我讨厌自己，因为我是一个糟糕的人，不配活着变成了活着的意义是什么?	认知歪曲,认知歪曲##乱贴标签
我现在意识到我最喜欢的自杀方式是一枪爆头。	情绪反应,情绪反应##行为效应
当我有一大堆痛苦的事情要回忆或喋喋不休时，我无法让片刻的快乐持续下去。	认知歪曲,认知歪曲##妄下结论
即使它不是来自那片海洋，我也可以从其他角度看待我的生活，并对自己感到失望。	认知歪曲,认知歪曲##情绪化推理
忽略了我生活中抑郁的内省原因，另一个原因是我的生活完全没有意义。	驳斥,驳斥##习惯性驳斥
这是一项令人麻木的任务，我的余生都要忍受，因为我看不到未来	驳斥,驳斥##习惯性驳斥
有趣的是，我在五年级的时候因为自残被送进了医院，并且有四次自杀未遂，最后一次是在高中毕业的时候。	情绪反应,情绪反应##行为效应
我的父母在我很小的时候就离婚了，在我成长的过程中，我再也没有相处过	触发性事件,触发性事件##生活
我参了军，却因为无法控制的伤病被踢了出来	触发性事件,触发性事件##生活
试过上大学，但开始逃课，最后第一学期不及格	触发性事件,触发性事件##学习工作
和我唯一的朋友吵了一架，让我一个朋友都没有	触发性事件,触发性事件##生活
还有一个月前我的第一个女朋友为了更好的人甩了我，就在我生日那天	触发性事件,触发性事件##情感
我的家人在另一个国家度假，我独自在家三个星期	触发性事件,触发性事件##生活
我不知道该做什么，也不知道怎么做	情绪反应,情绪反应##情感效应
我他妈的恨我自己	认知歪曲,认知歪曲##否定正面思考
作为一名大一新生，我的学业成绩在班上排名第六，我参加了校篮球队和校田径队，我会演奏两种乐器。	触发性事件,触发性事件##学习工作
我从六年级就开始自残了	情绪反应,情绪反应##行为效应
老实说，我太没价值了，没人会把我当熟人看待。	认知歪曲,认知歪曲##乱贴标签
这么有潜力，但我还是失败了。	认知歪曲,认知歪曲##乱贴标签
我什么都不喜欢了。	驳斥,驳斥##有效驳斥
无论我多么努力，我都找不到我真正喜欢做的事情，当我还是个孩子的时候，电子游戏就是它，我总是从它们那里得到一种神奇的感觉，我真的很开心。	认知歪曲,认知歪曲##以偏概全
我基本上是在大学里做苦工，但我对未来没有计划，我对任何事情都不太期待。	驳斥,驳斥##习惯性驳斥
我厌倦了生活	触发性事件,触发性事件##情感
我逃了四年的学	触发性事件,触发性事件##学习工作
考虑到我是一个甚至不会做基础数学和写一篇简单文章的笨蛋	认知歪曲,认知歪曲##乱贴标签
我对一切都不满意	认知歪曲,认知歪曲##否定正面思考
如果我够聪明，有些问题是可以解决的。但我真的知道我不是	驳斥,驳斥##习惯性驳斥
我在社交方面太不熟练，找不到工作，所以我不得不依靠我可怜的父亲的收入	触发性事件,触发性事件##学习工作
但是没有不痛苦的路可走，不是吗?	驳斥,驳斥##习惯性驳斥
一个错误毁了我的一生。	认知歪曲,认知歪曲##以偏概全
星期一晚上我入店行窃被抓了，有人报了警	触发性事件,触发性事件##生活
我收到了一张一级轻罪的罚单我的出庭日期是10月9号。这不是我第一次偷东西，但这个习惯直到两周前才形成，我只是想冒险一下。	触发性事件,触发性事件##生活
我是一名高三学生，现在我很有可能无法进入我想要的大学，也无法获得经济援助。	触发性事件,触发性事件##学习工作
我这辈子做的每件事都是对的，成绩好，行为值得信赖，ACT考试32分，是多个荣誉社团的成员等等	触发性事件,触发性事件##生活
我把我的整个未来都搞砸了	认知歪曲,认知歪曲##非此即彼
因为每个人都对我感到沮丧和失望	认知歪曲,认知歪曲##妄下结论
老实说，我看不出有什么出路。	认知歪曲,认知歪曲##以偏概全
的只有一条出路，我只想让这一切停止。	情绪反应,情绪反应##情感效应
我总觉得没人喜欢我	认知歪曲,认知歪曲##情绪化推理
也没人想和我出去玩。	触发性事件,触发性事件##社会关系
即使是我的朋友也总是一起出去玩	触发性事件,触发性事件##社会关系
我只是觉得我不属于任何地方，所以我总是把自己关在房间里	认知歪曲,认知歪曲##以偏概全
我有多孤独我的我的生活毫无方向	认知歪曲,认知歪曲##非此即彼
但是如果他们不喜欢我，那又有什么意义呢	认知歪曲,认知歪曲##以偏概全
我在我的好朋友西尔维娅的储物柜前找到她，约她出去，当时只有我们两个人。(我对她已经有几个月的迷恋了)，但她说她和我没有同样的感觉	触发性事件,触发性事件##情感
皮特(我)真的很有趣，他很酷，但我们做朋友更好。	触发性事件,触发性事件##情感
我注意到西尔维娅在snapchat上屏蔽了我	触发性事件,触发性事件##社会关系
她好像都在躲着我	触发性事件,触发性事件##社会关系
她说西尔维娅把我挡在门外然后又躲着我不太像她的性格。	认知歪曲,认知歪曲##情绪化推理
每次我试着单独和她说话，或者和她在一起的一群人说话，不管我说什么愚蠢的笑话，其他人都会笑，但她看起来很沮丧	认知歪曲,认知歪曲##情绪化推理
好像她因为我还活着而难过似的。	认知歪曲,认知歪曲##情绪化推理
我们本来是好朋友，然后一切都搞砸了。	认知歪曲,认知歪曲##以偏概全
发生的每一件小事都在告诉我，我多么不属于这里。	认知歪曲,认知歪曲##以偏概全
我只想摆脱这破事。我希望我可以上床睡觉，再也不用起床了。	情绪反应,情绪反应##情感效应
我奶奶经常责怪我	触发性事件,触发性事件##生活
我爷爷骂了我一顿	触发性事件,触发性事件##生活
我的朋友们一直在说我坏话	触发性事件,触发性事件##社会关系
我父母和姐姐都不跟我说话	触发性事件,触发性事件##生活
我的前女友忙着和她的新男友在一起	触发性事件,触发性事件##情感
我的家人都很生我的气因为我不想在叔叔家过圣诞节	触发性事件,触发性事件##生活
我他妈的太累了。我再也受不了了	情绪反应,情绪反应##情感效应
去他妈的这个世界。操每一个人	情绪反应,情绪反应##情感效应
我的父母从来不在我身边，我基本上是自己抚养自己	触发性事件,触发性事件##生活
我和比我大的人混在一起他们吸毒，偷车	触发性事件,触发性事件##生活
基本上就是一直嗑药。	触发性事件,触发性事件##生活
但我仍然感到空虚	情绪反应,情绪反应##情感效应
我每天都感到这种痛苦	情绪反应,情绪反应##情感效应
我觉得活着没有任何意义了	认知歪曲,认知歪曲##否定正面思考
我不指望别人把我当回事。我都不知道我还能不能把自己当回事。	认知歪曲,认知歪曲##否定正面思考
我现在的计划是吃一堆镇静剂，喝一堆伏特加，然后一旦我开始昏倒，在我头上套个塑料袋，在脖子上缠上胶带	情绪反应,情绪反应##行为效应
我在意大利一家五星级温泉酒店做救生员/看门人/工厂工人。	触发性事件,触发性事件##学习工作
我无法与人建立联系，每次开车去上班，我都会感到一种巨大的空虚感。	触发性事件,触发性事件##社会关系
我觉得很无聊，没有任何情绪。我对这些东西很熟悉，因为我已经接受了4年的治疗，	触发性事件,触发性事件##疾病症状
我接受了生活抛给我的一切，无论是耻辱还是机遇，我都能安然度过难关。	驳斥,驳斥##有效驳斥
随着新冠疫情的持续，我不能去游泳，这是我缓解痛苦的唯一方法。	触发性事件,触发性事件##生活
因为大多数时候我认为他们打电话给我是为了不为他们在我小时候不够爱我而感到内疚。	认知歪曲,认知歪曲##否定正面思考
我的父亲虐待我的母亲和我，就像我的母亲和妹妹对我一样，	触发性事件,触发性事件##生活
我一直是个问题孩子:	认知歪曲,认知歪曲##乱贴标签
我曾经偷过我妈妈的钱包，甚至是我奶奶的钱包，我偷过我妹妹的钱包，以得到我想要的东西。我不会偷陌生人的东西，但我会毫无悔意地偷他们的东西。我经常在学校的事情上撒谎，我把偷来的大部分钱都花在了学校里，把自己灌醉	触发性事件,触发性事件##生活
我恨我自己。我经常在纸上写下对自己的侮辱，希望我能改变自己的一些东西，采取行动，改变我讨厌的、阴沉的污秽，拥抱我真正想要的生活。	驳斥,驳斥##有效驳斥
我真的觉得我在这个世界上格格不入，我不适合这个伟大的宇宙机制，也就是这个存在	认知歪曲,认知歪曲##心理过滤
我不应该得到比这种困境更好的东西。	认知歪曲,认知歪曲##应该句式
我在这里，一个没有激情的稻草人，情感植物人，	认知歪曲,认知歪曲##乱贴标签
我只是在浪费空气和空间。	认知歪曲,认知歪曲##心理过滤
我不想活了	情绪反应,情绪反应##行为效应
我从小就被虐待	触发性事件,触发性事件##生活
我被性侵过好几次	触发性事件,触发性事件##生活
我失去了一个自杀的父母	触发性事件,触发性事件##生活
我周围的人拥有世界上所有的优势，他们过着“正常”的生活，一点也不能理解我是什么感觉。	触发性事件,触发性事件##社会关系
，我有创伤后应激障碍	触发性事件,触发性事件##疾病症状
再多的治疗和药物也不能让我好起来	认知歪曲,认知歪曲##妄下结论
结束这段感情的想法一直存在，但最近这种想法越来越强烈。	触发性事件,触发性事件##情感
但我坐在这里哭着，向一些我甚至不相信的东西祈祷我不会醒来	情绪反应,情绪反应##情感效应
但我坐在这里哭着，向一些我甚至不相信的东西祈祷我不会醒来，	情绪反应,情绪反应##行为效应
但是当我不做的时候，我的家人会因为我不做而对我大喊大叫	触发性事件,触发性事件##生活
我一直在想死	情绪反应,情绪反应##行为效应
学校里的人都把钥匙当笑话说	触发性事件,触发性事件##生活
在学校没有朋友	触发性事件,触发性事件##生活
我感到孤独	情绪反应,情绪反应##情感效应
但有时我只是觉得自己像一坨屎	认知歪曲,认知歪曲##乱贴标签
我每天都会犯错	认知歪曲,认知歪曲##以偏概全
我想在不久的将来自杀	情绪反应,情绪反应##行为效应
我不知道如果我走了谁会在乎，我的家人不会在乎，我学校的人也不会在乎，如果我走了，他们会更开心	认知歪曲,认知歪曲##情绪化推理
我觉得活下去都没有意义了	认知歪曲,认知歪曲##心理过滤
我已经到了没有动力去做任何事情的地步，我只想让一切都结束	认知歪曲,认知歪曲##否定正面思考
我想结束自己的生命。	情绪反应,情绪反应##情感效应
我在学校不及格。	触发性事件,触发性事件##学习工作
没人在乎我。我所有的朋友?是假的。他们都不带我出去玩，背着我做计划。	触发性事件,触发性事件##生活
我父母不久前离婚了，我从来没见过我父亲。此外，由于这个原因，我几乎没有机会见到我的兄弟姐妹，因为他们大多住在他家里，而我发现很难去看望他们，因为我忙于学校。	触发性事件,触发性事件##生活
每次我觉得自己在进步，却又回到了起点。	驳斥,驳斥##习惯性驳斥
我在当地的五金店搜索绳子的价格，以防我想上吊自杀。我现在唯一能想到的就是要么用厨房里能找到的最大的刀刺死自己，要么过量服用安眠药。	情绪反应,情绪反应##行为效应
我讨厌告诉自己事情会变好的，因为它们从来没有变好。	认知歪曲,认知歪曲##否定正面思考
每天我醒来，独自一人。我一个人吃饭。我独自入睡。从来没人问过我过得怎么样。没人关心我的生活。	触发性事件,触发性事件##生活
如果我现在死了，没人会在乎的。	驳斥,驳斥##习惯性驳斥
。我童年的最后几年充满了情感上的摧残。我哪里做错了?我怎么会让自己变得如此孤独?	情绪反应,情绪反应##情感效应
我不正常。	认知歪曲,认知歪曲##乱贴标签
但我知道他们所感受到的痛苦远不及我。	认知歪曲,认知歪曲##妄下结论
我也会这样做，在内心深处我是一个善良的人。我想看到每个人都成功，都快乐。	驳斥,驳斥##有效驳斥
我能感觉到空虚又回来了。我真的很害怕永远一个人。情感麻木又回来了，我的噩梦开始成真。	情绪反应,情绪反应##情感效应
我的生命毫无价值。我的目的是什么?每天受苦?	认知歪曲,认知歪曲##情绪化推理
被诊断为精神分裂	触发性事件,触发性事件##疾病症状
我确实会有幻觉、偏执和妄想	触发性事件,触发性事件##疾病症状
我也会经历我只能形容为“躁狂期”和“严重抑郁发作”的症状。我现在是残疾人	触发性事件,触发性事件##疾病症状
我每月500美元根本不够用	触发性事件,触发性事件##生活
我已经断药将近一个月了，因为我没有那该死的10块钱	触发性事件,触发性事件##生活
我一直身体疼痛(	触发性事件,触发性事件##疾病症状
也负担不起治疗药物	触发性事件,触发性事件##生活
是的，持续的疼痛，很多时候几乎不能走路。	触发性事件,触发性事件##疾病症状
我成了我妻子和母亲的负担	认知歪曲,认知歪曲##罪责归己/他
而我已经把这一切从她身边夺走了	认知歪曲,认知歪曲##罪责归己/他
因为我就是个垃圾，	认知歪曲,认知歪曲##乱贴标签
我儿子来看我的时候，我甚至不能和他一起玩，	触发性事件,触发性事件##社会关系
如果我死了，我的妻子会很高兴，我的儿子可以不再来这里，他的继父是一个比我更好的父亲。	认知歪曲,认知歪曲##情绪化推理
但我不能那样做，所以我不知道该怎么办。唯一能让我分心的是电子游戏，但我在游戏上投入了太多时间，以至于它不再管用了……真的，如此迷失自我可能是不健康的	驳斥,驳斥##有效驳斥
最好办法就是自杀	情绪反应,情绪反应##情感效应
我感到空虚，我什么都没有了。	驳斥,驳斥##习惯性驳斥
我已经被抑郁症折磨了好几个月了。	触发性事件,触发性事件##疾病症状
我试过SSRI，但它让事情变得更糟。	认知歪曲,认知歪曲##妄下结论
昨天，在我们度过了美好的几天之后，他和我分手了。	触发性事件,触发性事件##情感
我有莫名的焦虑。	触发性事件,触发性事件##疾病症状
我在大学里花了几年时间，才有资格得到一份我讨厌的工作。	触发性事件,触发性事件##学习工作
只是，我不能，因为从那以后我被诊断出患有严重的抑郁症，这是一种有抑郁症病史就无法胜任的职业。	触发性事件,触发性事件##疾病症状
我没有进步，反而越来越糟。	认知歪曲,认知歪曲##妄下结论
我不能再这样下去了。我不能再这样下去了。	驳斥,驳斥##有效驳斥
我大学一年级，我不得不退学，因为我无法适应在一所重点大学里不交朋友，不处理大学水平的工作。	触发性事件,触发性事件##学习工作
我精神崩溃了，不得不去看治疗师和理疗师，我被开了左洛复和另一种我不记得的药。	触发性事件,触发性事件##疾病症状
我开始像高中时代一样和他们一起玩，并重新对自己有了信心。我又开始定期锻炼，感觉很好。	触发性事件,触发性事件##社会关系
我的车开始出问题了，因为我和很多女孩在一起——我被认为是一个“操男”。而那个和我初吻的女孩却因为这个原因不肯和我约会，因为她爸爸是个种族主义者。	触发性事件,触发性事件##情感
但在泡妞失败后，抑郁的想法很快又回来了。	情绪反应,情绪反应##情感效应
我开始产生妄想症	触发性事件,触发性事件##疾病症状
所有这些人都在抱怨，这更让我烦恼。我精神崩溃了，被送去看理疗师，以便与海军分离。	触发性事件,触发性事件##疾病症状
我开始不停地吃快餐，我停止锻炼，我在工作3个月后被解雇了。	触发性事件,触发性事件##学习工作
我开始想自杀了。	情绪反应,情绪反应##情感效应
我只是受够了，我没有能力感觉好一点	情绪反应,情绪反应##情感效应
我没有朋友，没有关系可以依靠。	触发性事件,触发性事件##社会关系
今天我告诉我妈我想自杀。	情绪反应,情绪反应##情感效应
从13岁(确诊)起就患有抑郁症和严重焦虑症。我还被诊断出患有饮食失调症，但后来康复了。	触发性事件,触发性事件##疾病症状
她说我是一个负担，告诉我她不知道如何处理我，我让她发疯了，或者干脆无视我。	认知歪曲,认知歪曲##罪责归己/他
我知道如果他对心理健康有更好的了解，他就能让我妈妈相信这是很严重的。	认知歪曲,认知歪曲##情绪化推理
我正在学习成为一名精神病学家，所以你已经猜到他们不支持这一点。	触发性事件,触发性事件##学习工作
我失业了，现在和父母住在一起，靠他们的保险，所以我不能搬出去，也不能自己住。	触发性事件,触发性事件##生活
去年我的身体和精神都倒退了，我体重增加了，我的痤疮很可怕	触发性事件,触发性事件##疾病症状
我没有一点自信	情绪反应,情绪反应##情感效应
我觉得自己是世界上最丑的人。	认知歪曲,认知歪曲##乱贴标签
除了剧烈的焦虑发作外，我还经历了精神分裂和脱轨。	触发性事件,触发性事件##疾病症状
当我正在做我的16项大学作业时	触发性事件,触发性事件##学习工作
我崩溃了，告诉她我再也受不了了，过去几周我一直在认真考虑自杀。	情绪反应,情绪反应##情感效应
她不是一个坏人，她经历了很多，但她明确表示，我的心理健康对她来说只是一个负担。	驳斥,驳斥##习惯性驳斥
一年多的慢性疼痛正在摧毁我。	触发性事件,触发性事件##疾病症状
我一直患有慢性尿道疼痛。	触发性事件,触发性事件##疾病症状
我可能真的得了一种无法治愈的痛苦疾病	认知歪曲,认知歪曲##放大和缩小,认知歪曲,认知歪曲##情绪化推理
正是这种疾病导致了我的症状，	认知歪曲,认知歪曲##以偏概全,认知歪曲,认知歪曲##情绪化推理
所以我可以做的诊断程序不仅会暂时加重我的疼痛，而且还会带来永久性的并发症。	认知歪曲,认知歪曲##非此即彼,认知歪曲,认知歪曲##情绪化推理
我要么忍受痛苦，希望它会消失，要么经历极其痛苦的诊断程序，这将使我的痛苦更加严重，要么接受痛苦的治疗。	认知歪曲,认知歪曲##非此即彼
这么年轻就要经历这一切，感觉太不公平了。大多数做这些手术的人年纪都大得多。	认知歪曲,认知歪曲##情绪化推理
一想到我不能像大多数同龄人那样过正常的性生活，就觉得很可怕	认知歪曲,认知歪曲##情绪化推理
不管我是否接受治疗，我都会一直感到疼痛。	认知歪曲,认知歪曲##非此即彼
自从三月份以来，我几乎每天都有焦虑症发作，而且常常伴有一阵阵的哭泣。	触发性事件,触发性事件##疾病症状
以我现在的状态，我不确定今年秋天能不能修完高年级的科学课程。	认知歪曲,认知歪曲##情绪化推理
因为没有人理解我所处的痛苦，任何人说什么都不能消除痛苦。	驳斥,驳斥##习惯性驳斥
我的命到头了。	情绪反应,情绪反应##行为效应
我被诊断出患有抑郁症。	触发性事件,触发性事件##疾病症状
我已经有一个星期想自杀了	情绪反应,情绪反应##行为效应
我以前试过，也自残过几次。	情绪反应,情绪反应##行为效应
我感到精疲力竭，毫无价值，这对我来说已经不重要了。	认知歪曲,认知歪曲##心理过滤
我一直在想，如果我把双臂切开，让自己流血而死，事情可能会简单些。	情绪反应,情绪反应##行为效应
我不配活在世上	认知歪曲,认知歪曲##乱贴标签
我很没用，明年我甚至不能按时完成高中学业了。	认知歪曲,认知歪曲##乱贴标签
很没用，明年我甚至不能按时完成高中学业了。	认知歪曲,认知歪曲##情绪化推理
我只会撒谎，让人失望，从来没做过有价值的事。	认知歪曲,认知歪曲##情绪化推理
也许我应该一直感觉糟糕，我就是一坨屎。	认知歪曲,认知歪曲##乱贴标签
如果我有枪，我可能早就自杀了。	情绪反应,情绪反应##行为效应
像我这样的人没有未来。	认知歪曲,认知歪曲##妄下结论
我什么事都做不对，什么事都来不及补救。	认知歪曲,认知歪曲##否定正面思考
现在，我这辈子大部分时间都是失败者。	认知歪曲,认知歪曲##乱贴标签
我越来越想自杀了。	情绪反应,情绪反应##行为效应
我绝对没有办法走出这个困境，	认知歪曲,认知歪曲##妄下结论
即使我可以，我也不知道我的生活要去哪里。	驳斥,驳斥##习惯性驳斥
我就是个懒蛋，	认知歪曲,认知歪曲##乱贴标签
我想我要割开我的手腕，然后流血而死。	情绪反应,情绪反应##行为效应
我丢了工作，现在处于失业状态。我拿了八万多的助学贷款却拿到了一个可疑的学位。	触发性事件,触发性事件##学习工作
无家可归的我无法在这里生存，冬天的寒冷会致命。	认知歪曲,认知歪曲##情绪化推理
其他人可以依靠父母来支持他们，而我不能。	触发性事件,触发性事件##生活
我时而相信自己的技能和项目，时而自我毁灭的怀疑让我觉得自己是个毫无价值的黑客。	认知歪曲,认知歪曲##乱贴标签,驳斥,驳斥##习惯性驳斥
我刚刚完成了演示。我给几个人看了，他们很喜欢，但我觉得他们可能只是出于礼貌。	认知歪曲,认知歪曲##心理过滤
感谢我没有生活，没有朋友的工作，让我变得神圣。	认知歪曲,认知歪曲##情绪化推理
如果当能量或金钱耗尽，那么我将永远深陷其中。	认知歪曲,认知歪曲##以偏概全
自杀念头。	情绪反应,情绪反应##行为效应
我一直在吸毒(现在不那么厉害了)、酗酒和抽烟。	情绪反应,情绪反应##行为效应
我的自杀念头一天比一天严重。	情绪反应,情绪反应##行为效应
我的一生就是一场灾难。	认知歪曲,认知歪曲##妄下结论
尽管如此，它还是给我的大脑带来了愤怒和错误的情绪。	情绪反应,情绪反应##情感效应
我太恨自己了，我受不了了。	认知歪曲,认知歪曲##罪责归己/他
我过量服用了Lyrica(10片以上)和Rivotril(3片以上)。	情绪反应,情绪反应##行为效应
我对一切都厌倦了。	认知歪曲,认知歪曲##否定正面思考
否则这将是我和你们最后的再见，	情绪反应,情绪反应##行为效应